PokerStars Hand #208966141595:  Hold'em No Limit ($0.25/$0.50 USD) - 2020/02/08 4:01:19 ET
Table 'Acamar V' 6-max Seat #3 is the button
Seat 1: pondtree312 ($49.50 in chips)
Seat 2: Rifama ($50 in chips)
Seat 3: spr1teg ($50.50 in chips)
pondtree312: posts small blind $0.25
Rifama: posts big blind $0.50
*** HOLE CARDS ***
spr1teg: raises $0.75 to $1.25
pondtree312: calls $1
Rifama: folds
*** FLOP *** [8d 3c Ad]
pondtree312: checks
spr1teg: checks
*** TURN *** [8d 3c Ad] [9c]
yumeko0001 joins the table at seat #5
pondtree312: checks
spr1teg: checks
*** RIVER *** [8d 3c Ad 9c] [6d]
pondtree312: checks
spr1teg: checks
*** SHOW DOWN ***
pondtree312: shows [5d Ks] (high card Ace)
spr1teg: shows [8s Jd] (a pair of Eights)
spr1teg collected $2.85 from pot
*** SUMMARY ***
Total pot $3 | Rake $0.15
Board [8d 3c Ad 9c 6d]
Seat 1: pondtree312 (small blind) showed [5d Ks] and lost with high card Ace
Seat 2: Rifama (big blind) folded before Flop
Seat 3: spr1teg (button) showed [8s Jd] and won ($2.85) with a pair of Eights


PokerStars Hand #208966158957:  Hold'em No Limit ($0.25/$0.50 USD) - 2020/02/08 4:02:32 ET
Table 'Acamar V' 6-max Seat #2 is the button
Seat 1: pondtree312 ($48.94 in chips)
Seat 2: Rifama ($50 in chips)
Seat 3: spr1teg ($51.60 in chips)
Seat 4: Piscivore ($50 in chips)
spr1teg: posts small blind $0.25
Piscivore: posts big blind $0.50
yumeko0001: sits out
Naughty_ept: sits out
*** HOLE CARDS ***
pondtree312: raises $1 to $1.50
Rifama: folds
spr1teg: folds
Piscivore: folds
Uncalled bet ($1) returned to pondtree312
pondtree312 collected $1.25 from pot
pondtree312: doesn't show hand
*** SUMMARY ***
Total pot $1.25 | Rake $0
Seat 1: pondtree312 collected ($1.25)
Seat 2: Rifama (button) folded before Flop (didn't bet)
Seat 3: spr1teg (small blind) folded before Flop
Seat 4: Piscivore (big blind) folded before Flop


PokerStars Hand #208966163788:  Hold'em No Limit ($0.25/$0.50 USD) - 2020/02/08 4:02:53 ET
Table 'Acamar V' 6-max Seat #3 is the button
Seat 1: pondtree312 ($49.69 in chips)
Seat 2: Rifama ($50 in chips)
Seat 3: spr1teg ($51.35 in chips)
Seat 4: Piscivore ($50 in chips)
Seat 5: yumeko0001 ($50 in chips)
Piscivore: posts small blind $0.25
yumeko0001: posts big blind $0.50
Naughty_ept: sits out
*** HOLE CARDS ***
pondtree312: folds
Rifama: folds
spr1teg: folds
Piscivore: raises $1 to $1.50
yumeko0001: folds
Uncalled bet ($1) returned to Piscivore
Piscivore collected $1 from pot
*** SUMMARY ***
Total pot $1 | Rake $0
Seat 1: pondtree312 folded before Flop (didn't bet)
Seat 2: Rifama folded before Flop (didn't bet)
Seat 3: spr1teg (button) folded before Flop (didn't bet)
Seat 4: Piscivore (small blind) collected ($1)
Seat 5: yumeko0001 (big blind) folded before Flop


PokerStars Hand #208966150726:  Hold'em No Limit ($0.25/$0.50 USD) - 2020/02/08 4:01:58 ET
Table 'Acamar V' 6-max Seat #1 is the button
Seat 1: pondtree312 ($48.25 in chips)
Seat 2: Rifama ($50 in chips)
Seat 3: spr1teg ($52.10 in chips)
Rifama: posts small blind $0.25
spr1teg: posts big blind $0.50
Piscivore: sits out
yumeko0001: sits out
Naughty_ept: sits out
*** HOLE CARDS ***
pondtree312: calls $0.50
Rifama: folds
spr1teg: checks
*** FLOP *** [2c 7h 7d]
spr1teg: checks
pondtree312: checks
*** TURN *** [2c 7h 7d] [7c]
spr1teg: checks
pondtree312: checks
*** RIVER *** [2c 7h 7d 7c] [Qc]
spr1teg: checks
pondtree312: checks
*** SHOW DOWN ***
spr1teg: shows [Ts 5d] (three of a kind, Sevens)
pondtree312: shows [Kh 9c] (three of a kind, Sevens - King kicker)
pondtree312 collected $1.19 from pot
*** SUMMARY ***
Total pot $1.25 | Rake $0.06
Board [2c 7h 7d 7c Qc]
Seat 1: pondtree312 (button) showed [Kh 9c] and won ($1.19) with three of a kind, Sevens
Seat 2: Rifama (small blind) folded before Flop
Seat 3: spr1teg (big blind) showed [Ts 5d] and lost with three of a kind, Sevens


PokerStars Hand #208966167681:  Hold'em No Limit ($0.25/$0.50 USD) - 2020/02/08 4:03:09 ET
Table 'Acamar V' 6-max Seat #4 is the button
Seat 1: pondtree312 ($49.69 in chips)
Seat 2: Rifama ($50 in chips)
Seat 3: spr1teg ($51.35 in chips)
Seat 4: Piscivore ($50.50 in chips)
Seat 5: yumeko0001 ($50 in chips)
Seat 6: Naughty_ept ($50 in chips)
yumeko0001: posts small blind $0.25
Naughty_ept: posts big blind $0.50
*** HOLE CARDS ***
pondtree312: calls $0.50
Rifama: folds
spr1teg: folds
Piscivore: raises $1.50 to $2
yumeko0001: folds
Naughty_ept: folds
pondtree312: calls $1.50
*** FLOP *** [6s 7h 6c]
pondtree312: checks
Piscivore: bets $2.50
pondtree312: folds
Uncalled bet ($2.50) returned to Piscivore
Piscivore collected $4.51 from pot
*** SUMMARY ***
Total pot $4.75 | Rake $0.24
Board [6s 7h 6c]
Seat 1: pondtree312 folded on the Flop
Seat 2: Rifama folded before Flop (didn't bet)
Seat 3: spr1teg folded before Flop (didn't bet)
Seat 4: Piscivore (button) collected ($4.51)
Seat 5: yumeko0001 (small blind) folded before Flop
Seat 6: Naughty_ept (big blind) folded before Flop


PokerStars Hand #208966186580:  Hold'em No Limit ($0.25/$0.50 USD) - 2020/02/08 4:04:28 ET
Table 'Acamar V' 6-max Seat #6 is the button
Seat 1: pondtree312 ($52.20 in chips)
Seat 2: Rifama ($50 in chips)
Seat 3: spr1teg ($51.35 in chips)
Seat 4: Piscivore ($50 in chips)
Seat 5: yumeko0001 ($50 in chips)
Seat 6: Naughty_ept ($50 in chips)
pondtree312: posts small blind $0.25
Rifama: posts big blind $0.50
*** HOLE CARDS ***
spr1teg: folds
Piscivore: folds
yumeko0001: folds
Naughty_ept: folds
pondtree312: raises $3 to $3.50
Rifama: folds
Uncalled bet ($3) returned to pondtree312
pondtree312 collected $1 from pot
pondtree312: doesn't show hand
*** SUMMARY ***
Total pot $1 | Rake $0
Seat 1: pondtree312 (small blind) collected ($1)
Seat 2: Rifama (big blind) folded before Flop
Seat 3: spr1teg folded before Flop (didn't bet)
Seat 4: Piscivore folded before Flop (didn't bet)
Seat 5: yumeko0001 folded before Flop (didn't bet)
Seat 6: Naughty_ept (button) folded before Flop (didn't bet)


PokerStars Hand #208966191428:  Hold'em No Limit ($0.25/$0.50 USD) - 2020/02/08 4:04:48 ET
Table 'Acamar V' 6-max Seat #1 is the button
Seat 1: pondtree312 ($52.70 in chips)
Seat 2: Rifama ($50 in chips)
Seat 3: spr1teg ($51.35 in chips)
Seat 4: Piscivore ($50 in chips)
Seat 5: yumeko0001 ($50 in chips)
Seat 6: Naughty_ept ($50 in chips)
Rifama: posts small blind $0.25
spr1teg: posts big blind $0.50
*** HOLE CARDS ***
Piscivore: folds
yumeko0001: folds
Piscivore leaves the table
Naughty_ept: folds
pondtree312: calls $0.50
Rifama: folds
spr1teg: checks
*** FLOP *** [4c 8s 5h]
spr1teg: checks
pondtree312: checks
*** TURN *** [4c 8s 5h] [6d]
spr1teg: checks
pondtree312: checks
*** RIVER *** [4c 8s 5h 6d] [2h]
spr1teg: checks
pondtree312: checks
*** SHOW DOWN ***
spr1teg: shows [Ac 5c] (a pair of Fives)
pondtree312: mucks hand
spr1teg collected $1.19 from pot
*** SUMMARY ***
Total pot $1.25 | Rake $0.06
Board [4c 8s 5h 6d 2h]
Seat 1: pondtree312 (button) mucked
Seat 2: Rifama (small blind) folded before Flop
Seat 3: spr1teg (big blind) showed [Ac 5c] and won ($1.19) with a pair of Fives
Seat 4: Piscivore folded before Flop (didn't bet)
Seat 5: yumeko0001 folded before Flop (didn't bet)
Seat 6: Naughty_ept folded before Flop (didn't bet)


PokerStars Hand #208966176079:  Hold'em No Limit ($0.25/$0.50 USD) - 2020/02/08 4:03:44 ET
Table 'Acamar V' 6-max Seat #5 is the button
Seat 1: pondtree312 ($47.69 in chips)
Seat 2: Rifama ($50 in chips)
Seat 3: spr1teg ($51.35 in chips)
Seat 4: Piscivore ($53.01 in chips)
Seat 5: yumeko0001 ($50 in chips)
Seat 6: Naughty_ept ($50 in chips)
Naughty_ept: posts small blind $0.25
pondtree312: posts big blind $0.50
*** HOLE CARDS ***
Rifama: folds
spr1teg: folds
Piscivore: raises $1 to $1.50
yumeko0001: folds
Naughty_ept: folds
pondtree312: raises $3.25 to $4.75
Piscivore: calls $3.25
*** FLOP *** [2c Th 7d]
pondtree312: bets $9.50
Piscivore: folds
Uncalled bet ($9.50) returned to pondtree312
pondtree312 collected $9.26 from pot
pondtree312: doesn't show hand
*** SUMMARY ***
Total pot $9.75 | Rake $0.49
Board [2c Th 7d]
Seat 1: pondtree312 (big blind) collected ($9.26)
Seat 2: Rifama folded before Flop (didn't bet)
Seat 3: spr1teg folded before Flop (didn't bet)
Seat 4: Piscivore folded on the Flop
Seat 5: yumeko0001 (button) folded before Flop (didn't bet)
Seat 6: Naughty_ept (small blind) folded before Flop


PokerStars Hand #208966198761:  Hold'em No Limit ($0.25/$0.50 USD) - 2020/02/08 4:05:18 ET
Table 'Acamar V' 6-max Seat #2 is the button
Seat 1: pondtree312 ($52.20 in chips)
Seat 2: Rifama ($50 in chips)
Seat 3: spr1teg ($52.04 in chips)
Seat 5: yumeko0001 ($50 in chips)
Seat 6: Naughty_ept ($50 in chips)
spr1teg: posts small blind $0.25
yumeko0001: posts big blind $0.50
*** HOLE CARDS ***
Naughty_ept: raises $0.75 to $1.25
pondtree312: folds
Rifama: raises $3 to $4.25
spr1teg: folds
yumeko0001: folds
Naughty_ept: raises $7.25 to $11.50
Rifama: folds
Uncalled bet ($7.25) returned to Naughty_ept
Naughty_ept collected $9.25 from pot
Naughty_ept: doesn't show hand
*** SUMMARY ***
Total pot $9.25 | Rake $0
Seat 1: pondtree312 folded before Flop (didn't bet)
Seat 2: Rifama (button) folded before Flop
Seat 3: spr1teg (small blind) folded before Flop
Seat 5: yumeko0001 (big blind) folded before Flop
Seat 6: Naughty_ept collected ($9.25)


PokerStars Hand #208966208442:  Hold'em No Limit ($0.25/$0.50 USD) - 2020/02/08 4:05:58 ET
Table 'Acamar V' 6-max Seat #3 is the button
Seat 1: pondtree312 ($52.20 in chips)
Seat 2: Rifama ($50 in chips)
Seat 3: spr1teg ($51.79 in chips)
Seat 5: yumeko0001 ($50 in chips)
Seat 6: Naughty_ept ($55 in chips)
yumeko0001: posts small blind $0.25
Naughty_ept: posts big blind $0.50
*** HOLE CARDS ***
pondtree312: folds
Rifama: folds
spr1teg: folds
yumeko0001: raises $0.75 to $1.25
Naughty_ept: folds
Uncalled bet ($0.75) returned to yumeko0001
yumeko0001 collected $1 from pot
yumeko0001: doesn't show hand
*** SUMMARY ***
Total pot $1 | Rake $0
Seat 1: pondtree312 folded before Flop (didn't bet)
Seat 2: Rifama folded before Flop (didn't bet)
Seat 3: spr1teg (button) folded before Flop (didn't bet)
Seat 5: yumeko0001 (small blind) collected ($1)
Seat 6: Naughty_ept (big blind) folded before Flop


PokerStars Hand #208966214250:  Hold'em No Limit ($0.25/$0.50 USD) - 2020/02/08 4:06:21 ET
Table 'Acamar V' 6-max Seat #5 is the button
Seat 1: pondtree312 ($52.20 in chips)
Seat 2: Rifama ($50 in chips)
Seat 3: spr1teg ($51.79 in chips)
Seat 5: yumeko0001 ($50.50 in chips)
Seat 6: Naughty_ept ($54.50 in chips)
Naughty_ept: posts small blind $0.25
pondtree312: posts big blind $0.50
*** HOLE CARDS ***
Rifama: folds
spr1teg: folds
yumeko0001: folds
Naughty_ept: raises $0.75 to $1.25
pondtree312: folds
Uncalled bet ($0.75) returned to Naughty_ept
Naughty_ept collected $1 from pot
Naughty_ept: doesn't show hand
*** SUMMARY ***
Total pot $1 | Rake $0
Seat 1: pondtree312 (big blind) folded before Flop
Seat 2: Rifama folded before Flop (didn't bet)
Seat 3: spr1teg folded before Flop (didn't bet)
Seat 5: yumeko0001 (button) folded before Flop (didn't bet)
Seat 6: Naughty_ept (small blind) collected ($1)


PokerStars Hand #208966218775:  Hold'em No Limit ($0.25/$0.50 USD) - 2020/02/08 4:06:40 ET
Table 'Acamar V' 6-max Seat #6 is the button
Seat 1: pondtree312 ($51.70 in chips)
Seat 2: Rifama ($50 in chips)
Seat 3: spr1teg ($51.79 in chips)
Seat 5: yumeko0001 ($50.50 in chips)
Seat 6: Naughty_ept ($55 in chips)
pondtree312: posts small blind $0.25
Rifama: posts big blind $0.50
*** HOLE CARDS ***
spr1teg: folds
yumeko0001: folds
Naughty_ept: raises $0.50 to $1
pondtree312: calls $0.75
Rifama: calls $0.50
*** FLOP *** [6c 9d 6d]
pondtree312: checks
Rifama: checks
Naughty_ept: bets $0.94
pondtree312: folds
Rifama: folds
Uncalled bet ($0.94) returned to Naughty_ept
Naughty_ept collected $2.85 from pot
Naughty_ept: doesn't show hand
*** SUMMARY ***
Total pot $3 | Rake $0.15
Board [6c 9d 6d]
Seat 1: pondtree312 (small blind) folded on the Flop
Seat 2: Rifama (big blind) folded on the Flop
Seat 3: spr1teg folded before Flop (didn't bet)
Seat 5: yumeko0001 folded before Flop (didn't bet)
Seat 6: Naughty_ept (button) collected ($2.85)


PokerStars Hand #208966226584:  Hold'em No Limit ($0.25/$0.50 USD) - 2020/02/08 4:07:12 ET
Table 'Acamar V' 6-max Seat #1 is the button
Seat 1: pondtree312 ($50.70 in chips)
Seat 2: Rifama ($50 in chips)
Seat 3: spr1teg ($51.79 in chips)
Seat 5: yumeko0001 ($50.50 in chips)
Seat 6: Naughty_ept ($56.85 in chips)
Rifama: posts small blind $0.25
spr1teg: posts big blind $0.50
*** HOLE CARDS ***
yumeko0001: raises $0.75 to $1.25
Naughty_ept: folds
pondtree312: folds
Rifama: folds
spr1teg: folds
Uncalled bet ($0.75) returned to yumeko0001
yumeko0001 collected $1.25 from pot
yumeko0001: doesn't show hand
*** SUMMARY ***
Total pot $1.25 | Rake $0
Seat 1: pondtree312 (button) folded before Flop (didn't bet)
Seat 2: Rifama (small blind) folded before Flop
Seat 3: spr1teg (big blind) folded before Flop
Seat 5: yumeko0001 collected ($1.25)
Seat 6: Naughty_ept folded before Flop (didn't bet)


PokerStars Hand #208966231289:  Hold'em No Limit ($0.25/$0.50 USD) - 2020/02/08 4:07:31 ET
Table 'Acamar V' 6-max Seat #2 is the button
Seat 1: pondtree312 ($50.70 in chips)
Seat 2: Rifama ($50 in chips)
Seat 3: spr1teg ($51.29 in chips)
Seat 5: yumeko0001 ($51.25 in chips)
Seat 6: Naughty_ept ($56.85 in chips)
spr1teg: posts small blind $0.25
yumeko0001: posts big blind $0.50
*** HOLE CARDS ***
Naughty_ept: raises $0.75 to $1.25
pondtree312: folds
Rifama: folds
spr1teg: folds
yumeko0001: folds
Uncalled bet ($0.75) returned to Naughty_ept
Naughty_ept collected $1.25 from pot
Naughty_ept: doesn't show hand
*** SUMMARY ***
Total pot $1.25 | Rake $0
Seat 1: pondtree312 folded before Flop (didn't bet)
Seat 2: Rifama (button) folded before Flop (didn't bet)
Seat 3: spr1teg (small blind) folded before Flop
Seat 5: yumeko0001 (big blind) folded before Flop
Seat 6: Naughty_ept collected ($1.25)


PokerStars Hand #208966234831:  Hold'em No Limit ($0.25/$0.50 USD) - 2020/02/08 4:07:45 ET
Table 'Acamar V' 6-max Seat #3 is the button
Seat 1: pondtree312 ($50.70 in chips)
Seat 2: Rifama ($50 in chips)
Seat 3: spr1teg ($51.04 in chips)
Seat 5: yumeko0001 ($50.75 in chips)
Seat 6: Naughty_ept ($57.60 in chips)
yumeko0001: posts small blind $0.25
Naughty_ept: posts big blind $0.50
*** HOLE CARDS ***
pondtree312: folds
Rifama: folds
spr1teg: raises $0.75 to $1.25
yumeko0001: raises $3.75 to $5
Naughty_ept: folds
spr1teg: folds
Uncalled bet ($3.75) returned to yumeko0001
yumeko0001 collected $3 from pot
yumeko0001: doesn't show hand
*** SUMMARY ***
Total pot $3 | Rake $0
Seat 1: pondtree312 folded before Flop (didn't bet)
Seat 2: Rifama folded before Flop (didn't bet)
Seat 3: spr1teg (button) folded before Flop
Seat 5: yumeko0001 (small blind) collected ($3)
Seat 6: Naughty_ept (big blind) folded before Flop


PokerStars Hand #208966238555:  Hold'em No Limit ($0.25/$0.50 USD) - 2020/02/08 4:08:00 ET
Table 'Acamar V' 6-max Seat #5 is the button
Seat 1: pondtree312 ($50.70 in chips)
Seat 2: Rifama ($50 in chips)
Seat 3: spr1teg ($50 in chips)
Seat 5: yumeko0001 ($52.50 in chips)
Seat 6: Naughty_ept ($57.10 in chips)
Naughty_ept: posts small blind $0.25
pondtree312: posts big blind $0.50
*** HOLE CARDS ***
Rifama: folds
spr1teg: folds
yumeko0001: folds
Rojocapo1987 joins the table at seat #4
Naughty_ept: raises $0.75 to $1.25
pondtree312: calls $0.75
*** FLOP *** [5d 3s 6s]
Naughty_ept: checks
pondtree312: checks
*** TURN *** [5d 3s 6s] [8h]
Naughty_ept: bets $1.90
pondtree312: calls $1.90
*** RIVER *** [5d 3s 6s 8h] [Kd]
Naughty_ept: bets $3.29
pondtree312: folds
Uncalled bet ($3.29) returned to Naughty_ept
Naughty_ept collected $5.98 from pot
Naughty_ept: doesn't show hand
*** SUMMARY ***
Total pot $6.30 | Rake $0.32
Board [5d 3s 6s 8h Kd]
Seat 1: pondtree312 (big blind) folded on the River
Seat 2: Rifama folded before Flop (didn't bet)
Seat 3: spr1teg folded before Flop (didn't bet)
Seat 5: yumeko0001 (button) folded before Flop (didn't bet)
Seat 6: Naughty_ept (small blind) collected ($5.98)


PokerStars Hand #208966250905:  Hold'em No Limit ($0.25/$0.50 USD) - 2020/02/08 4:08:52 ET
Table 'Acamar V' 6-max Seat #6 is the button
Seat 1: pondtree312 ($47.55 in chips)
Seat 2: Rifama ($50 in chips)
Seat 3: spr1teg ($50 in chips)
Seat 5: yumeko0001 ($52.50 in chips)
Seat 6: Naughty_ept ($59.93 in chips)
pondtree312: posts small blind $0.25
Rifama: posts big blind $0.50
Rojocapo1987: sits out
*** HOLE CARDS ***
spr1teg: folds
yumeko0001: folds
Naughty_ept: folds
pondtree312: calls $0.25
Rifama: checks
*** FLOP *** [Kd Qc 7c]
pondtree312: checks
Rifama: bets $0.50
pondtree312: folds
Uncalled bet ($0.50) returned to Rifama
Rifama collected $0.95 from pot
Rifama: doesn't show hand
*** SUMMARY ***
Total pot $1 | Rake $0.05
Board [Kd Qc 7c]
Seat 1: pondtree312 (small blind) folded on the Flop
Seat 2: Rifama (big blind) collected ($0.95)
Seat 3: spr1teg folded before Flop (didn't bet)
Seat 5: yumeko0001 folded before Flop (didn't bet)
Seat 6: Naughty_ept (button) folded before Flop (didn't bet)


PokerStars Hand #208966275422:  Hold'em No Limit ($0.25/$0.50 USD) - 2020/02/08 4:10:33 ET
Table 'Acamar V' 6-max Seat #2 is the button
Seat 1: pondtree312 ($51.40 in chips)
Seat 2: Rifama ($50.20 in chips)
Seat 3: spr1teg ($50 in chips)
Seat 4: Rojocapo1987 ($50 in chips)
Seat 5: yumeko0001 ($52.50 in chips)
Seat 6: Naughty_ept ($56.68 in chips)
spr1teg: posts small blind $0.25
Rojocapo1987: posts big blind $0.50
*** HOLE CARDS ***
yumeko0001: folds
Naughty_ept: folds
pondtree312: calls $0.50
Rifama: folds
spr1teg: calls $0.25
Rojocapo1987: checks
*** FLOP *** [5d 4h 6d]
spr1teg: checks
Rojocapo1987: checks
pondtree312: checks
*** TURN *** [5d 4h 6d] [Ks]
spr1teg: checks
Rojocapo1987: checks
pondtree312: bets $1
spr1teg: folds
Rojocapo1987: folds
Uncalled bet ($1) returned to pondtree312
pondtree312 collected $1.42 from pot
*** SUMMARY ***
Total pot $1.50 | Rake $0.08
Board [5d 4h 6d Ks]
Seat 1: pondtree312 collected ($1.42)
Seat 2: Rifama (button) folded before Flop (didn't bet)
Seat 3: spr1teg (small blind) folded on the Turn
Seat 4: Rojocapo1987 (big blind) folded on the Turn
Seat 5: yumeko0001 folded before Flop (didn't bet)
Seat 6: Naughty_ept folded before Flop (didn't bet)


PokerStars Hand #208966260447:  Hold'em No Limit ($0.25/$0.50 USD) - 2020/02/08 4:09:31 ET
Table 'Acamar V' 6-max Seat #1 is the button
Seat 1: pondtree312 ($47.05 in chips)
Seat 2: Rifama ($50.45 in chips)
Seat 3: spr1teg ($50 in chips)
Seat 5: yumeko0001 ($52.50 in chips)
Seat 6: Naughty_ept ($59.93 in chips)
Rifama: posts small blind $0.25
spr1teg: posts big blind $0.50
Rojocapo1987: sits out
*** HOLE CARDS ***
yumeko0001: folds
Naughty_ept: raises $0.75 to $1.25
pondtree312: calls $1.25
Rifama: folds
spr1teg: calls $0.75
*** FLOP *** [5d Ks 7s]
spr1teg: checks
Naughty_ept: checks
pondtree312: checks
*** TURN *** [5d Ks 7s] [Qs]
spr1teg: checks
Naughty_ept: bets $2
pondtree312: calls $2
spr1teg: folds
*** RIVER *** [5d Ks 7s Qs] [6s]
Naughty_ept: checks
pondtree312: bets $4
Naughty_ept: folds
Uncalled bet ($4) returned to pondtree312
pondtree312 collected $7.60 from pot
pondtree312: doesn't show hand
*** SUMMARY ***
Total pot $8 | Rake $0.40
Board [5d Ks 7s Qs 6s]
Seat 1: pondtree312 (button) collected ($7.60)
Seat 2: Rifama (small blind) folded before Flop
Seat 3: spr1teg (big blind) folded on the Turn
Seat 5: yumeko0001 folded before Flop (didn't bet)
Seat 6: Naughty_ept folded on the River


PokerStars Hand #208966288937:  Hold'em No Limit ($0.25/$0.50 USD) - 2020/02/08 4:11:28 ET
Table 'Acamar V' 6-max Seat #3 is the button
Seat 1: pondtree312 ($52.32 in chips)
Seat 2: Rifama ($50.20 in chips)
Seat 3: spr1teg ($50 in chips)
Seat 4: Rojocapo1987 ($50 in chips)
Seat 5: yumeko0001 ($52.50 in chips)
Seat 6: Naughty_ept ($56.68 in chips)
Rojocapo1987: posts small blind $0.25
yumeko0001: posts big blind $0.50
*** HOLE CARDS ***
Naughty_ept: folds
pondtree312: calls $0.50
Rifama: folds
spr1teg: folds
Rojocapo1987: raises $2 to $2.50
yumeko0001: folds
pondtree312: folds
Uncalled bet ($2) returned to Rojocapo1987
Rojocapo1987 collected $1.50 from pot
Rojocapo1987: doesn't show hand
*** SUMMARY ***
Total pot $1.50 | Rake $0
Seat 1: pondtree312 folded before Flop
Seat 2: Rifama folded before Flop (didn't bet)
Seat 3: spr1teg (button) folded before Flop (didn't bet)
Seat 4: Rojocapo1987 (small blind) collected ($1.50)
Seat 5: yumeko0001 (big blind) folded before Flop
Seat 6: Naughty_ept folded before Flop (didn't bet)


PokerStars Hand #208966293781:  Hold'em No Limit ($0.25/$0.50 USD) - 2020/02/08 4:11:48 ET
Table 'Acamar V' 6-max Seat #4 is the button
Seat 1: pondtree312 ($51.82 in chips)
Seat 2: Rifama ($50.20 in chips)
Seat 3: spr1teg ($50 in chips)
Seat 4: Rojocapo1987 ($51 in chips)
Seat 5: yumeko0001 ($52 in chips)
Seat 6: Naughty_ept ($56.68 in chips)
yumeko0001: posts small blind $0.25
Naughty_ept: posts big blind $0.50
*** HOLE CARDS ***
pondtree312: calls $0.50
Rifama: folds
spr1teg: folds
Rojocapo1987: folds
yumeko0001: calls $0.25
Naughty_ept: checks
*** FLOP *** [3h 5s Kc]
yumeko0001: checks
Naughty_ept: checks
pondtree312: bets $1.50
yumeko0001: calls $1.50
Naughty_ept: folds
*** TURN *** [3h 5s Kc] [9c]
yumeko0001: checks
pondtree312: checks
*** RIVER *** [3h 5s Kc 9c] [7s]
yumeko0001: bets $2.14
pondtree312: calls $2.14
*** SHOW DOWN ***
yumeko0001: shows [Jh Kd] (a pair of Kings)
pondtree312: mucks hand
yumeko0001 collected $8.34 from pot
*** SUMMARY ***
Total pot $8.78 | Rake $0.44
Board [3h 5s Kc 9c 7s]
Seat 1: pondtree312 mucked
Seat 2: Rifama folded before Flop (didn't bet)
Seat 3: spr1teg folded before Flop (didn't bet)
Seat 4: Rojocapo1987 (button) folded before Flop (didn't bet)
Seat 5: yumeko0001 (small blind) showed [Jh Kd] and won ($8.34) with a pair of Kings
Seat 6: Naughty_ept (big blind) folded on the Flop


PokerStars Hand #208966310109:  Hold'em No Limit ($0.25/$0.50 USD) - 2020/02/08 4:12:55 ET
Table 'Acamar V' 6-max Seat #5 is the button
Seat 1: pondtree312 ($47.68 in chips)
Seat 2: Rifama ($50.20 in chips)
Seat 3: spr1teg ($50 in chips)
Seat 4: Rojocapo1987 ($51 in chips)
Seat 5: yumeko0001 ($56.20 in chips)
Seat 6: Naughty_ept ($56.18 in chips)
Naughty_ept: posts small blind $0.25
pondtree312: posts big blind $0.50
*** HOLE CARDS ***
Rifama: folds
spr1teg: folds
Rojocapo1987: folds
yumeko0001: raises $0.75 to $1.25
Naughty_ept: folds
pondtree312: folds
Uncalled bet ($0.75) returned to yumeko0001
yumeko0001 collected $1.25 from pot
yumeko0001: doesn't show hand
*** SUMMARY ***
Total pot $1.25 | Rake $0
Seat 1: pondtree312 (big blind) folded before Flop
Seat 2: Rifama folded before Flop (didn't bet)
Seat 3: spr1teg folded before Flop (didn't bet)
Seat 4: Rojocapo1987 folded before Flop (didn't bet)
Seat 5: yumeko0001 (button) collected ($1.25)
Seat 6: Naughty_ept (small blind) folded before Flop


PokerStars Hand #208966313762:  Hold'em No Limit ($0.25/$0.50 USD) - 2020/02/08 4:13:10 ET
Table 'Acamar V' 6-max Seat #6 is the button
Seat 1: pondtree312 ($47.18 in chips)
Seat 2: Rifama ($50.20 in chips)
Seat 3: spr1teg ($50 in chips)
Seat 4: Rojocapo1987 ($51 in chips)
Seat 5: yumeko0001 ($56.95 in chips)
Seat 6: Naughty_ept ($55.93 in chips)
pondtree312: posts small blind $0.25
Rifama: posts big blind $0.50
*** HOLE CARDS ***
spr1teg: folds
Rojocapo1987: folds
yumeko0001: folds
Naughty_ept: raises $0.50 to $1
pondtree312: folds
Rifama: folds
Uncalled bet ($0.50) returned to Naughty_ept
Naughty_ept collected $1.25 from pot
Naughty_ept: doesn't show hand
*** SUMMARY ***
Total pot $1.25 | Rake $0
Seat 1: pondtree312 (small blind) folded before Flop
Seat 2: Rifama (big blind) folded before Flop
Seat 3: spr1teg folded before Flop (didn't bet)
Seat 4: Rojocapo1987 folded before Flop (didn't bet)
Seat 5: yumeko0001 folded before Flop (didn't bet)
Seat 6: Naughty_ept (button) collected ($1.25)


PokerStars Hand #208966316877:  Hold'em No Limit ($0.25/$0.50 USD) - 2020/02/08 4:13:23 ET
Table 'Acamar V' 6-max Seat #1 is the button
Seat 1: pondtree312 ($46.93 in chips)
Seat 2: Rifama ($50 in chips)
Seat 3: spr1teg ($50 in chips)
Seat 4: Rojocapo1987 ($51 in chips)
Seat 5: yumeko0001 ($56.95 in chips)
Seat 6: Naughty_ept ($56.68 in chips)
Rifama: posts small blind $0.25
spr1teg: posts big blind $0.50
*** HOLE CARDS ***
Rojocapo1987: folds
yumeko0001: folds
Naughty_ept: raises $0.75 to $1.25
pondtree312: calls $1.25
Rifama: folds
spr1teg: folds
*** FLOP *** [3h Qd 4d]
Naughty_ept: checks
pondtree312: checks
*** TURN *** [3h Qd 4d] [6h]
Naughty_ept: checks
pondtree312: checks
*** RIVER *** [3h Qd 4d 6h] [Th]
Naughty_ept: checks
pondtree312: checks
*** SHOW DOWN ***
Naughty_ept: shows [Ad 9c] (high card Ace)
pondtree312: mucks hand
Naughty_ept collected $3.09 from pot
*** SUMMARY ***
Total pot $3.25 | Rake $0.16
Board [3h Qd 4d 6h Th]
Seat 1: pondtree312 (button) mucked
Seat 2: Rifama (small blind) folded before Flop
Seat 3: spr1teg (big blind) folded before Flop
Seat 4: Rojocapo1987 folded before Flop (didn't bet)
Seat 5: yumeko0001 folded before Flop (didn't bet)
Seat 6: Naughty_ept showed [Ad 9c] and won ($3.09) with high card Ace


PokerStars Hand #208966327696:  Hold'em No Limit ($0.25/$0.50 USD) - 2020/02/08 4:14:07 ET
Table 'Acamar V' 6-max Seat #2 is the button
Seat 1: pondtree312 ($45.68 in chips)
Seat 2: Rifama ($50 in chips)
Seat 3: spr1teg ($50 in chips)
Seat 4: Rojocapo1987 ($51 in chips)
Seat 5: yumeko0001 ($56.95 in chips)
Seat 6: Naughty_ept ($58.52 in chips)
spr1teg: posts small blind $0.25
Rojocapo1987: posts big blind $0.50
*** HOLE CARDS ***
yumeko0001: folds
Naughty_ept: folds
pondtree312: folds
Rifama: raises $0.60 to $1.10
spr1teg: folds
Rojocapo1987: folds
Uncalled bet ($0.60) returned to Rifama
Rifama collected $1.25 from pot
Rifama: doesn't show hand
*** SUMMARY ***
Total pot $1.25 | Rake $0
Seat 1: pondtree312 folded before Flop (didn't bet)
Seat 2: Rifama (button) collected ($1.25)
Seat 3: spr1teg (small blind) folded before Flop
Seat 4: Rojocapo1987 (big blind) folded before Flop
Seat 5: yumeko0001 folded before Flop (didn't bet)
Seat 6: Naughty_ept folded before Flop (didn't bet)


PokerStars Hand #208966332081:  Hold'em No Limit ($0.25/$0.50 USD) - 2020/02/08 4:14:25 ET
Table 'Acamar V' 6-max Seat #3 is the button
Seat 1: pondtree312 ($45.68 in chips)
Seat 2: Rifama ($50.75 in chips)
Seat 3: spr1teg ($50 in chips)
Seat 4: Rojocapo1987 ($50.50 in chips)
Seat 5: yumeko0001 ($56.95 in chips)
Seat 6: Naughty_ept ($58.52 in chips)
Rojocapo1987: posts small blind $0.25
yumeko0001: posts big blind $0.50
*** HOLE CARDS ***
Naughty_ept: folds
pondtree312: calls $0.50
Rifama: folds
spr1teg: raises $1.50 to $2
Rojocapo1987: folds
yumeko0001: folds
pondtree312: calls $1.50
*** FLOP *** [4s 7s 8d]
pondtree312: checks
spr1teg: bets $1.75
pondtree312: calls $1.75
*** TURN *** [4s 7s 8d] [Ks]
pondtree312: checks
spr1teg: bets $5.23
pondtree312: folds
Uncalled bet ($5.23) returned to spr1teg
spr1teg collected $7.84 from pot
spr1teg: doesn't show hand
*** SUMMARY ***
Total pot $8.25 | Rake $0.41
Board [4s 7s 8d Ks]
Seat 1: pondtree312 folded on the Turn
Seat 2: Rifama folded before Flop (didn't bet)
Seat 3: spr1teg (button) collected ($7.84)
Seat 4: Rojocapo1987 (small blind) folded before Flop
Seat 5: yumeko0001 (big blind) folded before Flop
Seat 6: Naughty_ept folded before Flop (didn't bet)


PokerStars Hand #208966358271:  Hold'em No Limit ($0.25/$0.50 USD) - 2020/02/08 4:15:49 ET
Table 'Acamar V' 6-max Seat #5 is the button
Seat 1: pondtree312 ($40.93 in chips)
Seat 2: Rifama ($50.75 in chips)
Seat 3: spr1teg ($54.09 in chips)
Seat 4: Rojocapo1987 ($50.25 in chips)
Seat 5: yumeko0001 ($56.20 in chips)
Seat 6: Naughty_ept ($59.66 in chips)
Naughty_ept: posts small blind $0.25
pondtree312: posts big blind $0.50
*** HOLE CARDS ***
Rifama: folds
spr1teg: folds
Rojocapo1987: folds
yumeko0001: folds
Naughty_ept: calls $0.25
pondtree312: checks
*** FLOP *** [9s 7d 2s]
Naughty_ept: bets $0.52
pondtree312: calls $0.52
*** TURN *** [9s 7d 2s] [Ks]
Naughty_ept: bets $0.64
pondtree312: calls $0.64
*** RIVER *** [9s 7d 2s Ks] [Ts]
Naughty_ept: bets $1.04
pondtree312: folds
Uncalled bet ($1.04) returned to Naughty_ept
Naughty_ept collected $3.15 from pot
Naughty_ept: doesn't show hand
*** SUMMARY ***
Total pot $3.32 | Rake $0.17
Board [9s 7d 2s Ks Ts]
Seat 1: pondtree312 (big blind) folded on the River
Seat 2: Rifama folded before Flop (didn't bet)
Seat 3: spr1teg folded before Flop (didn't bet)
Seat 4: Rojocapo1987 folded before Flop (didn't bet)
Seat 5: yumeko0001 (button) folded before Flop (didn't bet)
Seat 6: Naughty_ept (small blind) collected ($3.15)


PokerStars Hand #208966347019:  Hold'em No Limit ($0.25/$0.50 USD) - 2020/02/08 4:15:03 ET
Table 'Acamar V' 6-max Seat #4 is the button
Seat 1: pondtree312 ($41.93 in chips)
Seat 2: Rifama ($50.75 in chips)
Seat 3: spr1teg ($54.09 in chips)
Seat 4: Rojocapo1987 ($50.25 in chips)
Seat 5: yumeko0001 ($56.45 in chips)
Seat 6: Naughty_ept ($58.52 in chips)
yumeko0001: posts small blind $0.25
Naughty_ept: posts big blind $0.50
*** HOLE CARDS ***
pondtree312: calls $0.50
Rifama: folds
spr1teg: folds
Rojocapo1987: folds
yumeko0001: folds
Naughty_ept: checks
*** FLOP *** [3h 2s 7c]
Naughty_ept: bets $0.50
pondtree312: calls $0.50
*** TURN *** [3h 2s 7c] [As]
Naughty_ept: checks
pondtree312: checks
*** RIVER *** [3h 2s 7c As] [Ah]
Naughty_ept: bets $0.50
pondtree312: folds
Uncalled bet ($0.50) returned to Naughty_ept
Naughty_ept collected $2.14 from pot
Naughty_ept: doesn't show hand
*** SUMMARY ***
Total pot $2.25 | Rake $0.11
Board [3h 2s 7c As Ah]
Seat 1: pondtree312 folded on the River
Seat 2: Rifama folded before Flop (didn't bet)
Seat 3: spr1teg folded before Flop (didn't bet)
Seat 4: Rojocapo1987 (button) folded before Flop (didn't bet)
Seat 5: yumeko0001 (small blind) folded before Flop
Seat 6: Naughty_ept (big blind) collected ($2.14)


PokerStars Hand #208966367719:  Hold'em No Limit ($0.25/$0.50 USD) - 2020/02/08 4:16:27 ET
Table 'Acamar V' 6-max Seat #6 is the button
Seat 1: pondtree312 ($39.27 in chips)
Seat 2: Rifama ($50.75 in chips)
Seat 3: spr1teg ($54.09 in chips)
Seat 4: Rojocapo1987 ($50.25 in chips)
Seat 5: yumeko0001 ($56.20 in chips)
Seat 6: Naughty_ept ($61.15 in chips)
pondtree312: posts small blind $0.25
Rifama: posts big blind $0.50
*** HOLE CARDS ***
spr1teg: folds
Rojocapo1987: raises $1 to $1.50
yumeko0001: folds
Naughty_ept: folds
pondtree312: folds
Rifama: raises $4.22 to $5.72
Rojocapo1987: folds
Uncalled bet ($4.22) returned to Rifama
Rifama collected $3.25 from pot
Rifama: doesn't show hand
*** SUMMARY ***
Total pot $3.25 | Rake $0
Seat 1: pondtree312 (small blind) folded before Flop
Seat 2: Rifama (big blind) collected ($3.25)
Seat 3: spr1teg folded before Flop (didn't bet)
Seat 4: Rojocapo1987 folded before Flop
Seat 5: yumeko0001 folded before Flop (didn't bet)
Seat 6: Naughty_ept (button) folded before Flop (didn't bet)


PokerStars Hand #208966383372:  Hold'em No Limit ($0.25/$0.50 USD) - 2020/02/08 4:17:30 ET
Table 'Acamar V' 6-max Seat #2 is the button
Seat 1: pondtree312 ($53.37 in chips)
Seat 2: Rifama ($52.25 in chips)
Seat 3: spr1teg ($53.59 in chips)
Seat 4: Rojocapo1987 ($50 in chips)
Seat 5: yumeko0001 ($56.20 in chips)
Seat 6: Naughty_ept ($58.20 in chips)
spr1teg: posts small blind $0.25
Rojocapo1987: posts big blind $0.50
*** HOLE CARDS ***
yumeko0001: folds
Naughty_ept: folds
pondtree312: folds
Rifama: folds
spr1teg: raises $0.75 to $1.25
Rojocapo1987: calls $0.75
*** FLOP *** [8h Ah 9s]
spr1teg: bets $0.76
Rojocapo1987: calls $0.76
*** TURN *** [8h Ah 9s] [Tc]
spr1teg: bets $2.55
Rojocapo1987: calls $2.55
*** RIVER *** [8h Ah 9s Tc] [6s]
spr1teg: checks
Rojocapo1987: checks
*** SHOW DOWN ***
spr1teg: shows [7s Qs] (a straight, Six to Ten)
Rojocapo1987: mucks hand
spr1teg collected $8.66 from pot
*** SUMMARY ***
Total pot $9.12 | Rake $0.46
Board [8h Ah 9s Tc 6s]
Seat 1: pondtree312 folded before Flop (didn't bet)
Seat 2: Rifama (button) folded before Flop (didn't bet)
Seat 3: spr1teg (small blind) showed [7s Qs] and won ($8.66) with a straight, Six to Ten
Seat 4: Rojocapo1987 (big blind) mucked
Seat 5: yumeko0001 folded before Flop (didn't bet)
Seat 6: Naughty_ept folded before Flop (didn't bet)


PokerStars Hand #208966374037:  Hold'em No Limit ($0.25/$0.50 USD) - 2020/02/08 4:16:53 ET
Table 'Acamar V' 6-max Seat #1 is the button
Seat 1: pondtree312 ($50 in chips)
Seat 2: Rifama ($52.50 in chips)
Seat 3: spr1teg ($54.09 in chips)
Seat 4: Rojocapo1987 ($50 in chips)
Seat 5: yumeko0001 ($56.20 in chips)
Seat 6: Naughty_ept ($61.15 in chips)
Rifama: posts small blind $0.25
spr1teg: posts big blind $0.50
*** HOLE CARDS ***
Rojocapo1987: folds
yumeko0001: folds
Naughty_ept: raises $0.75 to $1.25
pondtree312: calls $1.25
Rifama: folds
spr1teg: folds
*** FLOP *** [Ac 5c 8c]
Naughty_ept: bets $1.70
pondtree312: raises $6.30 to $8
Naughty_ept: folds
Uncalled bet ($6.30) returned to pondtree312
pondtree312 collected $6.32 from pot
pondtree312: doesn't show hand
*** SUMMARY ***
Total pot $6.65 | Rake $0.33
Board [Ac 5c 8c]
Seat 1: pondtree312 (button) collected ($6.32)
Seat 2: Rifama (small blind) folded before Flop
Seat 3: spr1teg (big blind) folded before Flop
Seat 4: Rojocapo1987 folded before Flop (didn't bet)
Seat 5: yumeko0001 folded before Flop (didn't bet)
Seat 6: Naughty_ept folded on the Flop


PokerStars Hand #208966401687:  Hold'em No Limit ($0.25/$0.50 USD) - 2020/02/08 4:18:44 ET
Table 'Acamar V' 6-max Seat #4 is the button
Seat 1: pondtree312 ($52.87 in chips)
Seat 2: Rifama ($52.25 in chips)
Seat 3: spr1teg ($57.69 in chips)
Seat 4: Rojocapo1987 ($51 in chips)
Seat 5: yumeko0001 ($55.70 in chips)
Seat 6: Naughty_ept ($58.20 in chips)
yumeko0001: posts small blind $0.25
Naughty_ept: posts big blind $0.50
*** HOLE CARDS ***
pondtree312: calls $0.50
Rifama: folds
spr1teg: raises $1.50 to $2
Rojocapo1987: folds
yumeko0001: folds
Naughty_ept: folds
pondtree312: calls $1.50
*** FLOP *** [7d Qd Kd]
pondtree312: bets $3
spr1teg: calls $3
*** TURN *** [7d Qd Kd] [7s]
pondtree312: checks
spr1teg: checks
*** RIVER *** [7d Qd Kd 7s] [5d]
pondtree312: bets $5
spr1teg: calls $5
*** SHOW DOWN ***
pondtree312: shows [8s 6s] (a pair of Sevens)
spr1teg: shows [Qh Jd] (a flush, King high)
spr1teg collected $19.71 from pot
*** SUMMARY ***
Total pot $20.75 | Rake $1.04
Board [7d Qd Kd 7s 5d]
Seat 1: pondtree312 showed [8s 6s] and lost with a pair of Sevens
Seat 2: Rifama folded before Flop (didn't bet)
Seat 3: spr1teg showed [Qh Jd] and won ($19.71) with a flush, King high
Seat 4: Rojocapo1987 (button) folded before Flop (didn't bet)
Seat 5: yumeko0001 (small blind) folded before Flop
Seat 6: Naughty_ept (big blind) folded before Flop


PokerStars Hand #208966395706:  Hold'em No Limit ($0.25/$0.50 USD) - 2020/02/08 4:18:20 ET
Table 'Acamar V' 6-max Seat #3 is the button
Seat 1: pondtree312 ($53.37 in chips)
Seat 2: Rifama ($52.25 in chips)
Seat 3: spr1teg ($57.69 in chips)
Seat 4: Rojocapo1987 ($50 in chips)
Seat 5: yumeko0001 ($56.20 in chips)
Seat 6: Naughty_ept ($58.20 in chips)
Rojocapo1987: posts small blind $0.25
yumeko0001: posts big blind $0.50
*** HOLE CARDS ***
Naughty_ept: folds
pondtree312: calls $0.50
Rifama: folds
spr1teg: folds
Rojocapo1987: raises $2 to $2.50
yumeko0001: folds
pondtree312: folds
Uncalled bet ($2) returned to Rojocapo1987
Rojocapo1987 collected $1.50 from pot
Rojocapo1987: doesn't show hand
*** SUMMARY ***
Total pot $1.50 | Rake $0
Seat 1: pondtree312 folded before Flop
Seat 2: Rifama folded before Flop (didn't bet)
Seat 3: spr1teg (button) folded before Flop (didn't bet)
Seat 4: Rojocapo1987 (small blind) collected ($1.50)
Seat 5: yumeko0001 (big blind) folded before Flop
Seat 6: Naughty_ept folded before Flop (didn't bet)


PokerStars Hand #208966418501:  Hold'em No Limit ($0.25/$0.50 USD) - 2020/02/08 4:19:51 ET
Table 'Acamar V' 6-max Seat #6 is the button
Seat 1: pondtree312 ($42.37 in chips)
Seat 2: Rifama ($52.25 in chips)
Seat 3: spr1teg ($68.15 in chips)
Seat 4: Rojocapo1987 ($51 in chips)
Seat 5: yumeko0001 ($55.45 in chips)
Seat 6: Naughty_ept ($57.45 in chips)
pondtree312: posts small blind $0.25
Rifama: posts big blind $0.50
*** HOLE CARDS ***
spr1teg: folds
Rojocapo1987: folds
yumeko0001: folds
Naughty_ept: raises $0.50 to $1
pondtree312: folds
Rifama: calls $0.50
*** FLOP *** [3d Qc As]
Rifama: checks
Naughty_ept: bets $0.71
Rifama: folds
Uncalled bet ($0.71) returned to Naughty_ept
Naughty_ept collected $2.14 from pot
Naughty_ept: doesn't show hand
*** SUMMARY ***
Total pot $2.25 | Rake $0.11
Board [3d Qc As]
Seat 1: pondtree312 (small blind) folded before Flop
Seat 2: Rifama (big blind) folded on the Flop
Seat 3: spr1teg folded before Flop (didn't bet)
Seat 4: Rojocapo1987 folded before Flop (didn't bet)
Seat 5: yumeko0001 folded before Flop (didn't bet)
Seat 6: Naughty_ept (button) collected ($2.14)


PokerStars Hand #208966413868:  Hold'em No Limit ($0.25/$0.50 USD) - 2020/02/08 4:19:33 ET
Table 'Acamar V' 6-max Seat #5 is the button
Seat 1: pondtree312 ($42.87 in chips)
Seat 2: Rifama ($52.25 in chips)
Seat 3: spr1teg ($67.40 in chips)
Seat 4: Rojocapo1987 ($51 in chips)
Seat 5: yumeko0001 ($55.45 in chips)
Seat 6: Naughty_ept ($57.70 in chips)
Naughty_ept: posts small blind $0.25
pondtree312: posts big blind $0.50
*** HOLE CARDS ***
Rifama: folds
spr1teg: raises $0.75 to $1.25
Rojocapo1987: folds
yumeko0001: folds
Naughty_ept: folds
pondtree312: folds
Uncalled bet ($0.75) returned to spr1teg
spr1teg collected $1.25 from pot
spr1teg: doesn't show hand
*** SUMMARY ***
Total pot $1.25 | Rake $0
Seat 1: pondtree312 (big blind) folded before Flop
Seat 2: Rifama folded before Flop (didn't bet)
Seat 3: spr1teg collected ($1.25)
Seat 4: Rojocapo1987 folded before Flop (didn't bet)
Seat 5: yumeko0001 (button) folded before Flop (didn't bet)
Seat 6: Naughty_ept (small blind) folded before Flop


PokerStars Hand #208966426302:  Hold'em No Limit ($0.25/$0.50 USD) - 2020/02/08 4:20:22 ET
Table 'Acamar V' 6-max Seat #1 is the button
Seat 1: pondtree312 ($42.12 in chips)
Seat 2: Rifama ($51.25 in chips)
Seat 3: spr1teg ($68.15 in chips)
Seat 4: Rojocapo1987 ($51 in chips)
Seat 5: yumeko0001 ($55.45 in chips)
Seat 6: Naughty_ept ($58.59 in chips)
Rifama: posts small blind $0.25
spr1teg: posts big blind $0.50
*** HOLE CARDS ***
Rojocapo1987: folds
yumeko0001: folds
Naughty_ept: raises $0.75 to $1.25
pondtree312: folds
Rifama: folds
spr1teg: calls $0.75
*** FLOP *** [Td 3d 2h]
spr1teg: checks
Naughty_ept: bets $1.50
spr1teg: raises $3.74 to $5.24
Naughty_ept: folds
Uncalled bet ($3.74) returned to spr1teg
spr1teg collected $5.46 from pot
spr1teg: doesn't show hand
*** SUMMARY ***
Total pot $5.75 | Rake $0.29
Board [Td 3d 2h]
Seat 1: pondtree312 (button) folded before Flop (didn't bet)
Seat 2: Rifama (small blind) folded before Flop
Seat 3: spr1teg (big blind) collected ($5.46)
Seat 4: Rojocapo1987 folded before Flop (didn't bet)
Seat 5: yumeko0001 folded before Flop (didn't bet)
Seat 6: Naughty_ept folded on the Flop


PokerStars Hand #208966442856:  Hold'em No Limit ($0.25/$0.50 USD) - 2020/02/08 4:21:29 ET
Table 'Acamar V' 6-max Seat #2 is the button
Seat 1: pondtree312 ($50 in chips)
Seat 2: Rifama ($51 in chips)
Seat 3: spr1teg ($70.86 in chips)
Seat 4: Rojocapo1987 ($51 in chips)
Seat 5: yumeko0001 ($55.45 in chips)
Seat 6: Naughty_ept ($55.84 in chips)
spr1teg: posts small blind $0.25
Rojocapo1987: posts big blind $0.50
*** HOLE CARDS ***
yumeko0001: folds
Naughty_ept: folds
pondtree312: folds
Rifama: folds
spr1teg: raises $0.75 to $1.25
Rojocapo1987: calls $0.75
*** FLOP *** [3d 8c 5c]
spr1teg: checks
Rojocapo1987: bets $1.31
spr1teg: folds
Uncalled bet ($1.31) returned to Rojocapo1987
Rojocapo1987 collected $2.38 from pot
Rojocapo1987: doesn't show hand
*** SUMMARY ***
Total pot $2.50 | Rake $0.12
Board [3d 8c 5c]
Seat 1: pondtree312 folded before Flop (didn't bet)
Seat 2: Rifama (button) folded before Flop (didn't bet)
Seat 3: spr1teg (small blind) folded on the Flop
Seat 4: Rojocapo1987 (big blind) collected ($2.38)
Seat 5: yumeko0001 folded before Flop (didn't bet)
Seat 6: Naughty_ept folded before Flop (didn't bet)


PokerStars Hand #208966467985:  Hold'em No Limit ($0.25/$0.50 USD) - 2020/02/08 4:23:10 ET
Table 'Acamar V' 6-max Seat #6 is the button
Seat 1: pondtree312 ($50.25 in chips)
Seat 2: Rifama ($51 in chips)
Seat 3: spr1teg ($69.61 in chips)
Seat 4: Rojocapo1987 ($51.38 in chips)
Seat 5: yumeko0001 ($56.55 in chips)
Seat 6: Naughty_ept ($55.09 in chips)
pondtree312: posts small blind $0.25
Rifama: posts big blind $0.50
*** HOLE CARDS ***
spr1teg: folds
Rojocapo1987: folds
yumeko0001: raises $0.75 to $1.25
Naughty_ept: folds
pondtree312: folds
Rifama: folds
Uncalled bet ($0.75) returned to yumeko0001
yumeko0001 collected $1.25 from pot
yumeko0001: doesn't show hand
*** SUMMARY ***
Total pot $1.25 | Rake $0
Seat 1: pondtree312 (small blind) folded before Flop
Seat 2: Rifama (big blind) folded before Flop
Seat 3: spr1teg folded before Flop (didn't bet)
Seat 4: Rojocapo1987 folded before Flop (didn't bet)
Seat 5: yumeko0001 collected ($1.25)
Seat 6: Naughty_ept (button) folded before Flop (didn't bet)


PokerStars Hand #208966463773:  Hold'em No Limit ($0.25/$0.50 USD) - 2020/02/08 4:22:53 ET
Table 'Acamar V' 6-max Seat #5 is the button
Seat 1: pondtree312 ($50 in chips)
Seat 2: Rifama ($51 in chips)
Seat 3: spr1teg ($69.61 in chips)
Seat 4: Rojocapo1987 ($51.38 in chips)
Seat 5: yumeko0001 ($56.55 in chips)
Seat 6: Naughty_ept ($55.34 in chips)
Naughty_ept: posts small blind $0.25
pondtree312: posts big blind $0.50
*** HOLE CARDS ***
Rifama: folds
spr1teg: folds
Rojocapo1987: folds
yumeko0001: folds
Naughty_ept: folds
Uncalled bet ($0.25) returned to pondtree312
pondtree312 collected $0.50 from pot
pondtree312: doesn't show hand
*** SUMMARY ***
Total pot $0.50 | Rake $0
Seat 1: pondtree312 (big blind) collected ($0.50)
Seat 2: Rifama folded before Flop (didn't bet)
Seat 3: spr1teg folded before Flop (didn't bet)
Seat 4: Rojocapo1987 folded before Flop (didn't bet)
Seat 5: yumeko0001 (button) folded before Flop (didn't bet)
Seat 6: Naughty_ept (small blind) folded before Flop


PokerStars Hand #208966459917:  Hold'em No Limit ($0.25/$0.50 USD) - 2020/02/08 4:22:37 ET
Table 'Acamar V' 6-max Seat #4 is the button
Seat 1: pondtree312 ($50 in chips)
Seat 2: Rifama ($51 in chips)
Seat 3: spr1teg ($69.61 in chips)
Seat 4: Rojocapo1987 ($50.63 in chips)
Seat 5: yumeko0001 ($56.80 in chips)
Seat 6: Naughty_ept ($55.84 in chips)
yumeko0001: posts small blind $0.25
Naughty_ept: posts big blind $0.50
*** HOLE CARDS ***
pondtree312: folds
Rifama: folds
spr1teg: folds
Rojocapo1987: raises $1 to $1.50
yumeko0001: folds
Naughty_ept: folds
Uncalled bet ($1) returned to Rojocapo1987
Rojocapo1987 collected $1.25 from pot
Rojocapo1987: doesn't show hand
*** SUMMARY ***
Total pot $1.25 | Rake $0
Seat 1: pondtree312 folded before Flop (didn't bet)
Seat 2: Rifama folded before Flop (didn't bet)
Seat 3: spr1teg folded before Flop (didn't bet)
Seat 4: Rojocapo1987 (button) collected ($1.25)
Seat 5: yumeko0001 (small blind) folded before Flop
Seat 6: Naughty_ept (big blind) folded before Flop


PokerStars Hand #208966450726:  Hold'em No Limit ($0.25/$0.50 USD) - 2020/02/08 4:22:01 ET
Table 'Acamar V' 6-max Seat #3 is the button
Seat 1: pondtree312 ($50 in chips)
Seat 2: Rifama ($51 in chips)
Seat 3: spr1teg ($69.61 in chips)
Seat 4: Rojocapo1987 ($52.13 in chips)
Seat 5: yumeko0001 ($55.45 in chips)
Seat 6: Naughty_ept ($55.84 in chips)
Rojocapo1987: posts small blind $0.25
yumeko0001: posts big blind $0.50
*** HOLE CARDS ***
Naughty_ept: folds
pondtree312: folds
Rifama: folds
spr1teg: folds
Rojocapo1987: raises $1 to $1.50
yumeko0001: calls $1
*** FLOP *** [7s Kh 2d]
Rojocapo1987: checks
yumeko0001: bets $1.14
Rojocapo1987: folds
Uncalled bet ($1.14) returned to yumeko0001
yumeko0001 collected $2.85 from pot
yumeko0001: doesn't show hand
*** SUMMARY ***
Total pot $3 | Rake $0.15
Board [7s Kh 2d]
Seat 1: pondtree312 folded before Flop (didn't bet)
Seat 2: Rifama folded before Flop (didn't bet)
Seat 3: spr1teg (button) folded before Flop (didn't bet)
Seat 4: Rojocapo1987 (small blind) folded on the Flop
Seat 5: yumeko0001 (big blind) collected ($2.85)
Seat 6: Naughty_ept folded before Flop (didn't bet)


PokerStars Hand #208966472058:  Hold'em No Limit ($0.25/$0.50 USD) - 2020/02/08 4:23:26 ET
Table 'Acamar V' 6-max Seat #1 is the button
Seat 1: pondtree312 ($50 in chips)
Seat 2: Rifama ($50.50 in chips)
Seat 3: spr1teg ($69.61 in chips)
Seat 4: Rojocapo1987 ($51.38 in chips)
Seat 5: yumeko0001 ($57.30 in chips)
Seat 6: Naughty_ept ($55.09 in chips)
Rifama: posts small blind $0.25
spr1teg: posts big blind $0.50
*** HOLE CARDS ***
Rojocapo1987: folds
yumeko0001: folds
Naughty_ept: folds
pondtree312: raises $1 to $1.50
Rifama: folds
spr1teg: folds
Uncalled bet ($1) returned to pondtree312
pondtree312 collected $1.25 from pot
pondtree312: doesn't show hand
*** SUMMARY ***
Total pot $1.25 | Rake $0
Seat 1: pondtree312 (button) collected ($1.25)
Seat 2: Rifama (small blind) folded before Flop
Seat 3: spr1teg (big blind) folded before Flop
Seat 4: Rojocapo1987 folded before Flop (didn't bet)
Seat 5: yumeko0001 folded before Flop (didn't bet)
Seat 6: Naughty_ept folded before Flop (didn't bet)


PokerStars Hand #208966493792:  Hold'em No Limit ($0.25/$0.50 USD) - 2020/02/08 4:24:52 ET
Table 'Acamar V' 6-max Seat #3 is the button
Seat 1: pondtree312 ($50.75 in chips)
Seat 2: Rifama ($50 in chips)
Seat 3: spr1teg ($68.86 in chips)
Seat 4: Rojocapo1987 ($50.88 in chips)
Seat 5: yumeko0001 ($57.30 in chips)
Seat 6: Naughty_ept ($62.18 in chips)
Rojocapo1987: posts small blind $0.25
yumeko0001: posts big blind $0.50
*** HOLE CARDS ***
Naughty_ept: folds
pondtree312: folds
Naughty_ept leaves the table
Rifama: folds
spr1teg: folds
Rojocapo1987: raises $1 to $1.50
yumeko0001: folds
Uncalled bet ($1) returned to Rojocapo1987
Rojocapo1987 collected $1 from pot
Rojocapo1987: doesn't show hand
*** SUMMARY ***
Total pot $1 | Rake $0
Seat 1: pondtree312 folded before Flop (didn't bet)
Seat 2: Rifama folded before Flop (didn't bet)
Seat 3: spr1teg (button) folded before Flop (didn't bet)
Seat 4: Rojocapo1987 (small blind) collected ($1)
Seat 5: yumeko0001 (big blind) folded before Flop
Seat 6: Naughty_ept folded before Flop (didn't bet)


PokerStars Hand #208966476365:  Hold'em No Limit ($0.25/$0.50 USD) - 2020/02/08 4:23:43 ET
Table 'Acamar V' 6-max Seat #2 is the button
Seat 1: pondtree312 ($50.75 in chips)
Seat 2: Rifama ($50.25 in chips)
Seat 3: spr1teg ($69.11 in chips)
Seat 4: Rojocapo1987 ($51.38 in chips)
Seat 5: yumeko0001 ($57.30 in chips)
Seat 6: Naughty_ept ($55.09 in chips)
spr1teg: posts small blind $0.25
Rojocapo1987: posts big blind $0.50
*** HOLE CARDS ***
yumeko0001: folds
Naughty_ept: raises $0.75 to $1.25
pondtree312: folds
Rifama: raises $3 to $4.25
spr1teg: folds
Rojocapo1987: folds
Naughty_ept: calls $3
*** FLOP *** [Tc 8s 4h]
Naughty_ept: checks
Rifama: bets $2.84
Naughty_ept: calls $2.84
*** TURN *** [Tc 8s 4h] [Th]
Naughty_ept: bets $10.25
Rifama: folds
Uncalled bet ($10.25) returned to Naughty_ept
Naughty_ept collected $14.18 from pot
Naughty_ept: doesn't show hand
*** SUMMARY ***
Total pot $14.93 | Rake $0.75
Board [Tc 8s 4h Th]
Seat 1: pondtree312 folded before Flop (didn't bet)
Seat 2: Rifama (button) folded on the Turn
Seat 3: spr1teg (small blind) folded before Flop
Seat 4: Rojocapo1987 (big blind) folded before Flop
Seat 5: yumeko0001 folded before Flop (didn't bet)
Seat 6: Naughty_ept collected ($14.18)


PokerStars Hand #208966499759:  Hold'em No Limit ($0.25/$0.50 USD) - 2020/02/08 4:25:16 ET
Table 'Acamar V' 6-max Seat #4 is the button
Seat 1: pondtree312 ($50.75 in chips)
Seat 2: Rifama ($50 in chips)
Seat 3: spr1teg ($68.86 in chips)
Seat 4: Rojocapo1987 ($51.38 in chips)
Seat 5: yumeko0001 ($56.80 in chips)
yumeko0001: posts small blind $0.25
pondtree312: posts big blind $0.50
*** HOLE CARDS ***
Rifama: folds
spr1teg: raises $0.75 to $1.25
Rojocapo1987: folds
yumeko0001: folds
pondtree312: calls $0.75
*** FLOP *** [Jd 4s 2c]
pondtree312: checks
spr1teg: bets $0.84
Spendill joins the table at seat #6
pondtree312: calls $0.84
*** TURN *** [Jd 4s 2c] [Jh]
pondtree312: checks
spr1teg: checks
*** RIVER *** [Jd 4s 2c Jh] [6d]
pondtree312: checks
spr1teg: checks
*** SHOW DOWN ***
pondtree312: shows [Tc Ks] (a pair of Jacks)
spr1teg: mucks hand
pondtree312 collected $4.21 from pot
*** SUMMARY ***
Total pot $4.43 | Rake $0.22
Board [Jd 4s 2c Jh 6d]
Seat 1: pondtree312 (big blind) showed [Tc Ks] and won ($4.21) with a pair of Jacks
Seat 2: Rifama folded before Flop (didn't bet)
Seat 3: spr1teg mucked
Seat 4: Rojocapo1987 (button) folded before Flop (didn't bet)
Seat 5: yumeko0001 (small blind) folded before Flop


PokerStars Hand #208966510047:  Hold'em No Limit ($0.25/$0.50 USD) - 2020/02/08 4:25:57 ET
Table 'Acamar V' 6-max Seat #5 is the button
Seat 1: pondtree312 ($52.87 in chips)
Seat 2: Rifama ($50 in chips)
Seat 3: spr1teg ($66.77 in chips)
Seat 4: Rojocapo1987 ($51.38 in chips)
Seat 5: yumeko0001 ($56.55 in chips)
pondtree312: posts small blind $0.25
Rifama: posts big blind $0.50
*** HOLE CARDS ***
spr1teg: folds
Rojocapo1987: folds
yumeko0001: folds
pondtree312: calls $0.25
Rifama: checks
*** FLOP *** [3c 9c 5c]
pondtree312: checks
Rifama: checks
*** TURN *** [3c 9c 5c] [Js]
pondtree312: bets $1
Rifama: raises $3.75 to $4.75
pondtree312: calls $3.75
*** RIVER *** [3c 9c 5c Js] [8d]
pondtree312: checks
Rifama: checks
*** SHOW DOWN ***
pondtree312: shows [6c 4h] (high card Jack)
Rifama: shows [5h Jd] (two pair, Jacks and Fives)
Rifama collected $9.98 from pot
*** SUMMARY ***
Total pot $10.50 | Rake $0.52
Board [3c 9c 5c Js 8d]
Seat 1: pondtree312 (small blind) showed [6c 4h] and lost with high card Jack
Seat 2: Rifama (big blind) showed [5h Jd] and won ($9.98) with two pair, Jacks and Fives
Seat 3: spr1teg folded before Flop (didn't bet)
Seat 4: Rojocapo1987 folded before Flop (didn't bet)
Seat 5: yumeko0001 (button) folded before Flop (didn't bet)


PokerStars Hand #208966543491:  Hold'em No Limit ($0.25/$0.50 USD) - 2020/02/08 4:28:10 ET
Table 'Acamar V' 6-max Seat #4 is the button
Seat 1: pondtree312 ($49.06 in chips)
Seat 2: Rifama ($55.23 in chips)
Seat 3: spr1teg ($66.02 in chips)
Seat 4: Rojocapo1987 ($50.63 in chips)
Seat 5: yumeko0001 ($56.05 in chips)
Seat 6: Spendill ($50 in chips)
yumeko0001: posts small blind $0.25
Spendill: posts big blind $0.50
*** HOLE CARDS ***
pondtree312: folds
Rifama: folds
spr1teg: folds
Rojocapo1987: raises $1 to $1.50
yumeko0001: folds
Spendill: calls $1
*** FLOP *** [6s Js 9d]
Spendill: checks
Rojocapo1987: bets $2.07
Spendill: folds
Uncalled bet ($2.07) returned to Rojocapo1987
Rojocapo1987 collected $3.09 from pot
Rojocapo1987: doesn't show hand
*** SUMMARY ***
Total pot $3.25 | Rake $0.16
Board [6s Js 9d]
Seat 1: pondtree312 folded before Flop (didn't bet)
Seat 2: Rifama folded before Flop (didn't bet)
Seat 3: spr1teg folded before Flop (didn't bet)
Seat 4: Rojocapo1987 (button) collected ($3.09)
Seat 5: yumeko0001 (small blind) folded before Flop
Seat 6: Spendill (big blind) folded on the Flop


PokerStars Hand #208966538620:  Hold'em No Limit ($0.25/$0.50 USD) - 2020/02/08 4:27:51 ET
Table 'Acamar V' 6-max Seat #3 is the button
Seat 1: pondtree312 ($48.31 in chips)
Seat 2: Rifama ($55.23 in chips)
Seat 3: spr1teg ($66.02 in chips)
Seat 4: Rojocapo1987 ($50.88 in chips)
Seat 5: yumeko0001 ($56.55 in chips)
Rojocapo1987: posts small blind $0.25
yumeko0001: posts big blind $0.50
Spendill: sits out
*** HOLE CARDS ***
pondtree312: raises $1 to $1.50
Rifama: folds
spr1teg: folds
Rojocapo1987: folds
yumeko0001: folds
Uncalled bet ($1) returned to pondtree312
pondtree312 collected $1.25 from pot
pondtree312: doesn't show hand
*** SUMMARY ***
Total pot $1.25 | Rake $0
Seat 1: pondtree312 collected ($1.25)
Seat 2: Rifama folded before Flop (didn't bet)
Seat 3: spr1teg (button) folded before Flop (didn't bet)
Seat 4: Rojocapo1987 (small blind) folded before Flop
Seat 5: yumeko0001 (big blind) folded before Flop


PokerStars Hand #208966535044:  Hold'em No Limit ($0.25/$0.50 USD) - 2020/02/08 4:27:36 ET
Table 'Acamar V' 6-max Seat #2 is the button
Seat 1: pondtree312 ($48.31 in chips)
Seat 2: Rifama ($54.48 in chips)
Seat 3: spr1teg ($66.27 in chips)
Seat 4: Rojocapo1987 ($51.38 in chips)
Seat 5: yumeko0001 ($56.55 in chips)
spr1teg: posts small blind $0.25
Rojocapo1987: posts big blind $0.50
Spendill: sits out
*** HOLE CARDS ***
yumeko0001: folds
pondtree312: folds
Rifama: raises $0.60 to $1.10
spr1teg: folds
Rojocapo1987: folds
Uncalled bet ($0.60) returned to Rifama
Rifama collected $1.25 from pot
Rifama: doesn't show hand
*** SUMMARY ***
Total pot $1.25 | Rake $0
Seat 1: pondtree312 folded before Flop (didn't bet)
Seat 2: Rifama (button) collected ($1.25)
Seat 3: spr1teg (small blind) folded before Flop
Seat 4: Rojocapo1987 (big blind) folded before Flop
Seat 5: yumeko0001 folded before Flop (didn't bet)


PokerStars Hand #208966524910:  Hold'em No Limit ($0.25/$0.50 USD) - 2020/02/08 4:26:56 ET
Table 'Acamar V' 6-max Seat #1 is the button
Seat 1: pondtree312 ($47.62 in chips)
Seat 2: Rifama ($54.73 in chips)
Seat 3: spr1teg ($66.77 in chips)
Seat 4: Rojocapo1987 ($51.38 in chips)
Seat 5: yumeko0001 ($56.55 in chips)
Rifama: posts small blind $0.25
spr1teg: posts big blind $0.50
Spendill: sits out
*** HOLE CARDS ***
Rojocapo1987: folds
yumeko0001: folds
pondtree312: calls $0.50
Rifama: folds
spr1teg: checks
*** FLOP *** [4h 5d 5s]
spr1teg: checks
pondtree312: checks
*** TURN *** [4h 5d 5s] [Td]
spr1teg: checks
pondtree312: checks
*** RIVER *** [4h 5d 5s Td] [2h]
spr1teg: checks
pondtree312: checks
*** SHOW DOWN ***
spr1teg: shows [Qh 3d] (a pair of Fives)
pondtree312: shows [2c As] (two pair, Fives and Deuces)
pondtree312 collected $1.19 from pot
*** SUMMARY ***
Total pot $1.25 | Rake $0.06
Board [4h 5d 5s Td 2h]
Seat 1: pondtree312 (button) showed [2c As] and won ($1.19) with two pair, Fives and Deuces
Seat 2: Rifama (small blind) folded before Flop
Seat 3: spr1teg (big blind) showed [Qh 3d] and lost with a pair of Fives
Seat 4: Rojocapo1987 folded before Flop (didn't bet)
Seat 5: yumeko0001 folded before Flop (didn't bet)


PokerStars Hand #208966551428:  Hold'em No Limit ($0.25/$0.50 USD) - 2020/02/08 4:28:41 ET
Table 'Acamar V' 6-max Seat #5 is the button
Seat 1: pondtree312 ($49.06 in chips)
Seat 2: Rifama ($55.23 in chips)
Seat 3: spr1teg ($66.02 in chips)
Seat 4: Rojocapo1987 ($52.22 in chips)
Seat 5: yumeko0001 ($55.80 in chips)
Seat 6: Spendill ($50 in chips)
Spendill: posts small blind $0.25
pondtree312: posts big blind $0.50
*** HOLE CARDS ***
Rifama: folds
spr1teg: raises $0.75 to $1.25
Rojocapo1987: folds
yumeko0001: folds
Spendill: folds
pondtree312: calls $0.75
*** FLOP *** [Qh 8c 3s]
pondtree312: checks
spr1teg: checks
*** TURN *** [Qh 8c 3s] [Qc]
pondtree312: checks
spr1teg: checks
*** RIVER *** [Qh 8c 3s Qc] [4c]
pondtree312: checks
spr1teg: checks
*** SHOW DOWN ***
pondtree312: shows [8h As] (two pair, Queens and Eights)
spr1teg: mucks hand
pondtree312 collected $2.61 from pot
*** SUMMARY ***
Total pot $2.75 | Rake $0.14
Board [Qh 8c 3s Qc 4c]
Seat 1: pondtree312 (big blind) showed [8h As] and won ($2.61) with two pair, Queens and Eights
Seat 2: Rifama folded before Flop (didn't bet)
Seat 3: spr1teg mucked
Seat 4: Rojocapo1987 folded before Flop (didn't bet)
Seat 5: yumeko0001 (button) folded before Flop (didn't bet)
Seat 6: Spendill (small blind) folded before Flop


PokerStars Hand #208966574705:  Hold'em No Limit ($0.25/$0.50 USD) - 2020/02/08 4:30:13 ET
Table 'Acamar V' 6-max Seat #3 is the button
Seat 2: Rifama ($55.68 in chips)
Seat 3: spr1teg ($64.52 in chips)
Seat 4: Rojocapo1987 ($51.72 in chips)
Seat 5: yumeko0001 ($55.80 in chips)
Seat 6: Spendill ($50.75 in chips)
Rojocapo1987: posts small blind $0.25
yumeko0001: posts big blind $0.50
*** HOLE CARDS ***
Spendill: folds
Rifama: raises $0.60 to $1.10
spr1teg: folds
Rojocapo1987: folds
yumeko0001: folds
Uncalled bet ($0.60) returned to Rifama
Rifama collected $1.25 from pot
Rifama: doesn't show hand
*** SUMMARY ***
Total pot $1.25 | Rake $0
Seat 2: Rifama collected ($1.25)
Seat 3: spr1teg (button) folded before Flop (didn't bet)
Seat 4: Rojocapo1987 (small blind) folded before Flop
Seat 5: yumeko0001 (big blind) folded before Flop
Seat 6: Spendill folded before Flop (didn't bet)


PokerStars Hand #208966560040:  Hold'em No Limit ($0.25/$0.50 USD) - 2020/02/08 4:29:16 ET
Table 'Acamar V' 6-max Seat #6 is the button
Seat 1: pondtree312 ($50.42 in chips)
Seat 2: Rifama ($55.23 in chips)
Seat 3: spr1teg ($64.77 in chips)
Seat 4: Rojocapo1987 ($52.22 in chips)
Seat 5: yumeko0001 ($55.80 in chips)
Seat 6: Spendill ($50 in chips)
pondtree312: posts small blind $0.25
Rifama: posts big blind $0.50
*** HOLE CARDS ***
spr1teg: folds
Rojocapo1987: folds
yumeko0001: folds
Spendill: folds
pondtree312: calls $0.25
Rifama: checks
*** FLOP *** [4c Ts 9c]
pondtree312: checks
Rifama: bets $0.64
pondtree312: folds
Uncalled bet ($0.64) returned to Rifama
Rifama collected $0.95 from pot
Rifama: doesn't show hand
pondtree312 leaves the table
*** SUMMARY ***
Total pot $1 | Rake $0.05
Board [4c Ts 9c]
Seat 1: pondtree312 (small blind) folded on the Flop
Seat 2: Rifama (big blind) collected ($0.95)
Seat 3: spr1teg folded before Flop (didn't bet)
Seat 4: Rojocapo1987 folded before Flop (didn't bet)
Seat 5: yumeko0001 folded before Flop (didn't bet)
Seat 6: Spendill (button) folded before Flop (didn't bet)


PokerStars Hand #208966569424:  Hold'em No Limit ($0.25/$0.50 USD) - 2020/02/08 4:29:53 ET
Table 'Acamar V' 6-max Seat #2 is the button
Seat 2: Rifama ($55.68 in chips)
Seat 3: spr1teg ($64.77 in chips)
Seat 4: Rojocapo1987 ($52.22 in chips)
Seat 5: yumeko0001 ($55.80 in chips)
Seat 6: Spendill ($50 in chips)
spr1teg: posts small blind $0.25
Rojocapo1987: posts big blind $0.50
*** HOLE CARDS ***
yumeko0001: folds
Spendill: raises $0.75 to $1.25
Rifama: folds
spr1teg: folds
Rojocapo1987: folds
Uncalled bet ($0.75) returned to Spendill
Spendill collected $1.25 from pot
Spendill: doesn't show hand
*** SUMMARY ***
Total pot $1.25 | Rake $0
Seat 2: Rifama (button) folded before Flop (didn't bet)
Seat 3: spr1teg (small blind) folded before Flop
Seat 4: Rojocapo1987 (big blind) folded before Flop
Seat 5: yumeko0001 folded before Flop (didn't bet)
Seat 6: Spendill collected ($1.25)


PokerStars Hand #208975681771:  Hold'em No Limit ($0.25/$0.50 USD) - 2020/02/08 11:13:54 ET
Table 'Acamar V' 6-max Seat #1 is the button
Seat 1: ph0en1x77791 ($50.50 in chips)
Seat 3: genie-kl ($39.50 in chips)
Seat 4: DerFlotti ($50 in chips)
Seat 6: olo0olo ($50 in chips)
genie-kl: posts small blind $0.25
DerFlotti: posts big blind $0.50
*** HOLE CARDS ***
ramanchi leaves the table
olo0olo: raises $0.60 to $1.10
ph0en1x77791: folds
genie-kl: calls $0.85
orbcrazyk joins the table at seat #2
DerFlotti: folds
*** FLOP *** [Qc 5c Ad]
genie-kl: checks
olo0olo: bets $0.84
genie-kl: calls $0.84
*** TURN *** [Qc 5c Ad] [9s]
genie-kl: checks
olo0olo: checks
*** RIVER *** [Qc 5c Ad 9s] [3c]
genie-kl: bets $4.16
olo0olo: folds
Uncalled bet ($4.16) returned to genie-kl
genie-kl collected $4.16 from pot
genie-kl: doesn't show hand
*** SUMMARY ***
Total pot $4.38 | Rake $0.22
Board [Qc 5c Ad 9s 3c]
Seat 1: ph0en1x77791 (button) folded before Flop (didn't bet)
Seat 3: genie-kl (small blind) collected ($4.16)
Seat 4: DerFlotti (big blind) folded before Flop
Seat 6: olo0olo folded on the River


PokerStars Hand #208975697476:  Hold'em No Limit ($0.25/$0.50 USD) - 2020/02/08 11:14:23 ET
Table 'Acamar V' 6-max Seat #3 is the button
Seat 1: ph0en1x77791 ($50.50 in chips)
Seat 3: genie-kl ($41.72 in chips)
Seat 4: DerFlotti ($49.50 in chips)
Seat 6: olo0olo ($50 in chips)
DerFlotti: posts small blind $0.25
olo0olo: posts big blind $0.50
orbcrazyk: sits out
*** HOLE CARDS ***
ph0en1x77791: folds
Axelll51 joins the table at seat #5
genie-kl: raises $0.50 to $1
DerFlotti: folds
olo0olo: folds
Uncalled bet ($0.50) returned to genie-kl
genie-kl collected $1.25 from pot
genie-kl: doesn't show hand
*** SUMMARY ***
Total pot $1.25 | Rake $0
Seat 1: ph0en1x77791 folded before Flop (didn't bet)
Seat 3: genie-kl (button) collected ($1.25)
Seat 4: DerFlotti (small blind) folded before Flop
Seat 6: olo0olo (big blind) folded before Flop


PokerStars Hand #208975724276:  Hold'em No Limit ($0.25/$0.50 USD) - 2020/02/08 11:15:13 ET
Table 'Acamar V' 6-max Seat #1 is the button
Seat 1: ph0en1x77791 ($58.72 in chips)
Seat 2: orbcrazyk ($50 in chips)
Seat 3: genie-kl ($41.97 in chips)
Seat 4: DerFlotti ($50 in chips)
Seat 5: Axelll51 ($29.18 in chips)
Seat 6: olo0olo ($50 in chips)
orbcrazyk: posts small blind $0.25
genie-kl: posts big blind $0.50
*** HOLE CARDS ***
DerFlotti: folds
Axelll51: folds
olo0olo: folds
ph0en1x77791: folds
olo0olo leaves the table
orbcrazyk: raises $1 to $1.50
genie-kl: folds
Uncalled bet ($1) returned to orbcrazyk
orbcrazyk collected $1 from pot
orbcrazyk: doesn't show hand
*** SUMMARY ***
Total pot $1 | Rake $0
Seat 1: ph0en1x77791 (button) folded before Flop (didn't bet)
Seat 2: orbcrazyk (small blind) collected ($1)
Seat 3: genie-kl (big blind) folded before Flop
Seat 4: DerFlotti folded before Flop (didn't bet)
Seat 5: Axelll51 folded before Flop (didn't bet)
Seat 6: olo0olo folded before Flop (didn't bet)


PokerStars Hand #208975705045:  Hold'em No Limit ($0.25/$0.50 USD) - 2020/02/08 11:14:37 ET
Table 'Acamar V' 6-max Seat #4 is the button
Seat 1: ph0en1x77791 ($50.50 in chips)
Seat 3: genie-kl ($42.47 in chips)
Seat 4: DerFlotti ($49.25 in chips)
Seat 6: olo0olo ($50 in chips)
olo0olo: posts small blind $0.25
ph0en1x77791: posts big blind $0.50
orbcrazyk: sits out
*** HOLE CARDS ***
genie-kl: calls $0.50
DerFlotti: folds
olo0olo: folds
ph0en1x77791: raises $2.25 to $2.75
genie-kl: folds
Uncalled bet ($2.25) returned to ph0en1x77791
ph0en1x77791 collected $1.25 from pot
ph0en1x77791: doesn't show hand
*** SUMMARY ***
Total pot $1.25 | Rake $0
Seat 1: ph0en1x77791 (big blind) collected ($1.25)
Seat 3: genie-kl folded before Flop
Seat 4: DerFlotti (button) folded before Flop (didn't bet)
Seat 6: olo0olo (small blind) folded before Flop


PokerStars Hand #208975712943:  Hold'em No Limit ($0.25/$0.50 USD) - 2020/02/08 11:14:52 ET
Table 'Acamar V' 6-max Seat #6 is the button
Seat 1: ph0en1x77791 ($51.25 in chips)
Seat 2: orbcrazyk ($50 in chips)
Seat 3: genie-kl ($41.97 in chips)
Seat 4: DerFlotti ($50 in chips)
Seat 5: Axelll51 ($29.68 in chips)
Seat 6: olo0olo ($50 in chips)
ph0en1x77791: posts small blind $0.25
orbcrazyk: posts big blind $0.50
Axelll51: posts big blind $0.50
*** HOLE CARDS ***
genie-kl: folds
DerFlotti: folds
Axelll51: checks
olo0olo: raises $1.50 to $2
ph0en1x77791: raises $5.25 to $7.25
orbcrazyk: folds
Axelll51: folds
olo0olo: calls $5.25
*** FLOP *** [Ac Ad 8d]
ph0en1x77791: bets $3.83
olo0olo: folds
Uncalled bet ($3.83) returned to ph0en1x77791
ph0en1x77791 collected $14.72 from pot
ph0en1x77791: doesn't show hand
*** SUMMARY ***
Total pot $15.50 | Rake $0.78
Board [Ac Ad 8d]
Seat 1: ph0en1x77791 (small blind) collected ($14.72)
Seat 2: orbcrazyk (big blind) folded before Flop
Seat 3: genie-kl folded before Flop (didn't bet)
Seat 4: DerFlotti folded before Flop (didn't bet)
Seat 5: Axelll51 folded before Flop (didn't bet)
Seat 6: olo0olo (button) folded on the Flop


PokerStars Hand #208975742611:  Hold'em No Limit ($0.25/$0.50 USD) - 2020/02/08 11:15:48 ET
Table 'Acamar V' 6-max Seat #3 is the button
Seat 1: ph0en1x77791 ($60.70 in chips)
Seat 2: orbcrazyk ($50.50 in chips)
Seat 3: genie-kl ($40.40 in chips)
Seat 4: DerFlotti ($48.93 in chips)
Seat 5: Axelll51 ($29.18 in chips)
DerFlotti: posts small blind $0.25
Axelll51: posts big blind $0.50
*** HOLE CARDS ***
ph0en1x77791: folds
orbcrazyk: folds
ChrisChamber joins the table at seat #6
genie-kl: folds
DerFlotti: folds
Uncalled bet ($0.25) returned to Axelll51
Axelll51 collected $0.50 from pot
*** SUMMARY ***
Total pot $0.50 | Rake $0
Seat 1: ph0en1x77791 folded before Flop (didn't bet)
Seat 2: orbcrazyk folded before Flop (didn't bet)
Seat 3: genie-kl (button) folded before Flop (didn't bet)
Seat 4: DerFlotti (small blind) folded before Flop
Seat 5: Axelll51 (big blind) collected ($0.50)


PokerStars Hand #208975731205:  Hold'em No Limit ($0.25/$0.50 USD) - 2020/02/08 11:15:26 ET
Table 'Acamar V' 6-max Seat #2 is the button
Seat 1: ph0en1x77791 ($58.72 in chips)
Seat 2: orbcrazyk ($50.50 in chips)
Seat 3: genie-kl ($41.47 in chips)
Seat 4: DerFlotti ($50 in chips)
Seat 5: Axelll51 ($29.18 in chips)
genie-kl: posts small blind $0.25
DerFlotti: posts big blind $0.50
*** HOLE CARDS ***
Axelll51: folds
ph0en1x77791: raises $0.57 to $1.07
orbcrazyk: folds
genie-kl: calls $0.82
DerFlotti: calls $0.57
*** FLOP *** [9h 8h Qd]
genie-kl: checks
Sun_Set_pro8 joins the table at seat #6
DerFlotti: checks
ph0en1x77791: bets $3.05
genie-kl: folds
Sun_Set_pro8 leaves the table
DerFlotti: folds
Uncalled bet ($3.05) returned to ph0en1x77791
ph0en1x77791 collected $3.05 from pot
ph0en1x77791: doesn't show hand
*** SUMMARY ***
Total pot $3.21 | Rake $0.16
Board [9h 8h Qd]
Seat 1: ph0en1x77791 collected ($3.05)
Seat 2: orbcrazyk (button) folded before Flop (didn't bet)
Seat 3: genie-kl (small blind) folded on the Flop
Seat 4: DerFlotti (big blind) folded on the Flop
Seat 5: Axelll51 folded before Flop (didn't bet)


PokerStars Hand #208975769334:  Hold'em No Limit ($0.25/$0.50 USD) - 2020/02/08 11:16:38 ET
Table 'Acamar V' 6-max Seat #5 is the button
Seat 1: ph0en1x77791 ($60.70 in chips)
Seat 2: orbcrazyk ($50.50 in chips)
Seat 3: genie-kl ($40.40 in chips)
Seat 4: DerFlotti ($46.59 in chips)
Seat 5: Axelll51 ($32.75 in chips)
Seat 6: ChrisChamber ($50 in chips)
ChrisChamber: posts small blind $0.25
ph0en1x77791: posts big blind $0.50
*** HOLE CARDS ***
orbcrazyk: folds
genie-kl: raises $1.25 to $1.75
DerFlotti: folds
Axelll51: calls $1.75
ChrisChamber: folds
ph0en1x77791: folds
*** FLOP *** [Ah 9s 7c]
genie-kl: bets $4.04
Axelll51: calls $4.04
*** TURN *** [Ah 9s 7c] [Kc]
genie-kl: bets $34.61 and is all-in
Axelll51: folds
Uncalled bet ($34.61) returned to genie-kl
genie-kl collected $11.71 from pot
genie-kl: doesn't show hand
*** SUMMARY ***
Total pot $12.33 | Rake $0.62
Board [Ah 9s 7c Kc]
Seat 1: ph0en1x77791 (big blind) folded before Flop
Seat 2: orbcrazyk folded before Flop (didn't bet)
Seat 3: genie-kl collected ($11.71)
Seat 4: DerFlotti folded before Flop (didn't bet)
Seat 5: Axelll51 (button) folded on the Turn
Seat 6: ChrisChamber (small blind) folded before Flop


PokerStars Hand #208975747272:  Hold'em No Limit ($0.25/$0.50 USD) - 2020/02/08 11:15:56 ET
Table 'Acamar V' 6-max Seat #4 is the button
Seat 1: ph0en1x77791 ($60.70 in chips)
Seat 2: orbcrazyk ($50.50 in chips)
Seat 3: genie-kl ($40.40 in chips)
Seat 4: DerFlotti ($49.75 in chips)
Seat 5: Axelll51 ($29.43 in chips)
Seat 6: ChrisChamber ($50 in chips)
Axelll51: posts small blind $0.25
ChrisChamber: posts big blind $0.50
*** HOLE CARDS ***
ph0en1x77791: folds
orbcrazyk: folds
genie-kl: folds
DerFlotti: raises $1 to $1.50
Axelll51: calls $1.25
ChrisChamber: folds
*** FLOP *** [Ks 8h Qc]
Axelll51: checks
DerFlotti: checks
*** TURN *** [Ks 8h Qc] [3s]
Axelll51: checks
DerFlotti: bets $1.66
Axelll51: calls $1.66
*** RIVER *** [Ks 8h Qc 3s] [7d]
Axelll51: checks
DerFlotti: checks
*** SHOW DOWN ***
Axelll51: shows [8c Ac] (a pair of Eights)
DerFlotti: mucks hand
Axelll51 collected $6.48 from pot
*** SUMMARY ***
Total pot $6.82 | Rake $0.34
Board [Ks 8h Qc 3s 7d]
Seat 1: ph0en1x77791 folded before Flop (didn't bet)
Seat 2: orbcrazyk folded before Flop (didn't bet)
Seat 3: genie-kl folded before Flop (didn't bet)
Seat 4: DerFlotti (button) mucked
Seat 5: Axelll51 (small blind) showed [8c Ac] and won ($6.48) with a pair of Eights
Seat 6: ChrisChamber (big blind) folded before Flop


PokerStars Hand #208975783074:  Hold'em No Limit ($0.25/$0.50 USD) - 2020/02/08 11:17:03 ET
Table 'Acamar V' 6-max Seat #6 is the button
Seat 1: ph0en1x77791 ($60.20 in chips)
Seat 2: orbcrazyk ($50.50 in chips)
Seat 3: genie-kl ($46.32 in chips)
Seat 4: DerFlotti ($50 in chips)
Seat 5: Axelll51 ($26.96 in chips)
Seat 6: ChrisChamber ($50 in chips)
ph0en1x77791: posts small blind $0.25
orbcrazyk: posts big blind $0.50
*** HOLE CARDS ***
genie-kl: folds
DerFlotti: folds
Axelll51: folds
ChrisChamber: folds
ph0en1x77791: raises $1 to $1.50
orbcrazyk: calls $1
*** FLOP *** [5h 4s 6c]
ph0en1x77791: checks
orbcrazyk: checks
*** TURN *** [5h 4s 6c] [Jh]
ph0en1x77791: bets $3.85
orbcrazyk: folds
Uncalled bet ($3.85) returned to ph0en1x77791
ph0en1x77791 collected $2.85 from pot
ph0en1x77791: doesn't show hand
*** SUMMARY ***
Total pot $3 | Rake $0.15
Board [5h 4s 6c Jh]
Seat 1: ph0en1x77791 (small blind) collected ($2.85)
Seat 2: orbcrazyk (big blind) folded on the Turn
Seat 3: genie-kl folded before Flop (didn't bet)
Seat 4: DerFlotti folded before Flop (didn't bet)
Seat 5: Axelll51 folded before Flop (didn't bet)
Seat 6: ChrisChamber (button) folded before Flop (didn't bet)


PokerStars Hand #208975807531:  Hold'em No Limit ($0.25/$0.50 USD) - 2020/02/08 11:17:49 ET
Table 'Acamar V' 6-max Seat #2 is the button
Seat 1: ph0en1x77791 ($63.30 in chips)
Seat 2: orbcrazyk ($50 in chips)
Seat 3: genie-kl ($45.82 in chips)
Seat 4: DerFlotti ($49.50 in chips)
Seat 5: Axelll51 ($26.46 in chips)
Seat 6: ChrisChamber ($50 in chips)
genie-kl: posts small blind $0.25
DerFlotti: posts big blind $0.50
*** HOLE CARDS ***
Axelll51: folds
ChrisChamber: folds
ph0en1x77791: raises $0.57 to $1.07
orbcrazyk: folds
genie-kl: folds
DerFlotti: calls $0.57
*** FLOP *** [Td Ts 6s]
DerFlotti: checks
ph0en1x77791: checks
*** TURN *** [Td Ts 6s] [As]
DerFlotti: checks
ph0en1x77791: checks
*** RIVER *** [Td Ts 6s As] [3c]
DerFlotti: checks
ph0en1x77791: checks
*** SHOW DOWN ***
DerFlotti: shows [8h Js] (a pair of Tens)
ph0en1x77791: mucks hand
DerFlotti collected $2.27 from pot
*** SUMMARY ***
Total pot $2.39 | Rake $0.12
Board [Td Ts 6s As 3c]
Seat 1: ph0en1x77791 mucked
Seat 2: orbcrazyk (button) folded before Flop (didn't bet)
Seat 3: genie-kl (small blind) folded before Flop
Seat 4: DerFlotti (big blind) showed [8h Js] and won ($2.27) with a pair of Tens
Seat 5: Axelll51 folded before Flop (didn't bet)
Seat 6: ChrisChamber folded before Flop (didn't bet)


PokerStars Hand #208975796814:  Hold'em No Limit ($0.25/$0.50 USD) - 2020/02/08 11:17:29 ET
Table 'Acamar V' 6-max Seat #1 is the button
Seat 1: ph0en1x77791 ($61.55 in chips)
Seat 2: orbcrazyk ($50 in chips)
Seat 3: genie-kl ($46.32 in chips)
Seat 4: DerFlotti ($50 in chips)
Seat 5: Axelll51 ($26.96 in chips)
Seat 6: ChrisChamber ($50 in chips)
orbcrazyk: posts small blind $0.25
genie-kl: posts big blind $0.50
*** HOLE CARDS ***
DerFlotti: calls $0.50
Axelll51: calls $0.50
ChrisChamber: folds
ph0en1x77791: raises $3 to $3.50
orbcrazyk: folds
genie-kl: folds
DerFlotti: folds
Axelll51: folds
Uncalled bet ($3) returned to ph0en1x77791
ph0en1x77791 collected $2.25 from pot
ph0en1x77791: doesn't show hand
*** SUMMARY ***
Total pot $2.25 | Rake $0
Seat 1: ph0en1x77791 (button) collected ($2.25)
Seat 2: orbcrazyk (small blind) folded before Flop
Seat 3: genie-kl (big blind) folded before Flop
Seat 4: DerFlotti folded before Flop
Seat 5: Axelll51 folded before Flop
Seat 6: ChrisChamber folded before Flop (didn't bet)


PokerStars Hand #208975851811:  Hold'em No Limit ($0.25/$0.50 USD) - 2020/02/08 11:19:12 ET
Table 'Acamar V' 6-max Seat #5 is the button
Seat 2: orbcrazyk ($50 in chips)
Seat 3: genie-kl ($42.93 in chips)
Seat 4: DerFlotti ($50.45 in chips)
Seat 5: Axelll51 ($26.46 in chips)
Seat 6: ChrisChamber ($52.61 in chips)
ChrisChamber: posts small blind $0.25
ph0en1x77791: is sitting out
ph0en1x77791 leaves the table
orbcrazyk: posts big blind $0.50
*** HOLE CARDS ***
genie-kl: folds
DerFlotti: folds
Axelll51: folds
ChrisChamber: folds
Uncalled bet ($0.25) returned to orbcrazyk
orbcrazyk collected $0.50 from pot
orbcrazyk: doesn't show hand
*** SUMMARY ***
Total pot $0.50 | Rake $0
Seat 2: orbcrazyk (big blind) collected ($0.50)
Seat 3: genie-kl folded before Flop (didn't bet)
Seat 4: DerFlotti folded before Flop (didn't bet)
Seat 5: Axelll51 (button) folded before Flop (didn't bet)
Seat 6: ChrisChamber (small blind) folded before Flop


PokerStars Hand #208975826486:  Hold'em No Limit ($0.25/$0.50 USD) - 2020/02/08 11:18:25 ET
Table 'Acamar V' 6-max Seat #3 is the button
Seat 1: ph0en1x77791 ($62.23 in chips)
Seat 2: orbcrazyk ($50 in chips)
Seat 3: genie-kl ($45.57 in chips)
Seat 4: DerFlotti ($50.70 in chips)
Seat 5: Axelll51 ($26.46 in chips)
Seat 6: ChrisChamber ($50 in chips)
DerFlotti: posts small blind $0.25
Axelll51: posts big blind $0.50
*** HOLE CARDS ***
ChrisChamber: folds
ph0en1x77791: folds
orbcrazyk: folds
genie-kl: folds
DerFlotti: folds
Uncalled bet ($0.25) returned to Axelll51
Axelll51 collected $0.50 from pot
*** SUMMARY ***
Total pot $0.50 | Rake $0
Seat 1: ph0en1x77791 folded before Flop (didn't bet)
Seat 2: orbcrazyk folded before Flop (didn't bet)
Seat 3: genie-kl (button) folded before Flop (didn't bet)
Seat 4: DerFlotti (small blind) folded before Flop
Seat 5: Axelll51 (big blind) collected ($0.50)
Seat 6: ChrisChamber folded before Flop (didn't bet)


PokerStars Hand #208975831360:  Hold'em No Limit ($0.25/$0.50 USD) - 2020/02/08 11:18:34 ET
Table 'Acamar V' 6-max Seat #4 is the button
Seat 1: ph0en1x77791 ($62.23 in chips)
Seat 2: orbcrazyk ($50 in chips)
Seat 3: genie-kl ($45.57 in chips)
Seat 4: DerFlotti ($50.45 in chips)
Seat 5: Axelll51 ($26.71 in chips)
Seat 6: ChrisChamber ($50 in chips)
Axelll51: posts small blind $0.25
ChrisChamber: posts big blind $0.50
*** HOLE CARDS ***
ph0en1x77791: folds
orbcrazyk: folds
genie-kl: calls $0.50
DerFlotti: folds
Axelll51: folds
ChrisChamber: checks
*** FLOP *** [9c 4d 7h]
ChrisChamber: checks
genie-kl: bets $0.50
ChrisChamber: raises $1.64 to $2.14
genie-kl: calls $1.64
*** TURN *** [9c 4d 7h] [Js]
ChrisChamber: bets $3.94
genie-kl: folds
Uncalled bet ($3.94) returned to ChrisChamber
ChrisChamber collected $5.25 from pot
ChrisChamber: doesn't show hand
*** SUMMARY ***
Total pot $5.53 | Rake $0.28
Board [9c 4d 7h Js]
Seat 1: ph0en1x77791 folded before Flop (didn't bet)
Seat 2: orbcrazyk folded before Flop (didn't bet)
Seat 3: genie-kl folded on the Turn
Seat 4: DerFlotti (button) folded before Flop (didn't bet)
Seat 5: Axelll51 (small blind) folded before Flop
Seat 6: ChrisChamber (big blind) collected ($5.25)


PokerStars Hand #208975866858:  Hold'em No Limit ($0.25/$0.50 USD) - 2020/02/08 11:19:40 ET
Table 'Acamar V' 6-max Seat #2 is the button
Seat 2: orbcrazyk ($52.53 in chips)
Seat 4: DerFlotti ($49.95 in chips)
Seat 5: Axelll51 ($24.46 in chips)
Seat 6: ChrisChamber ($52.36 in chips)
DerFlotti: posts small blind $0.25
Axelll51: posts big blind $0.50
*** HOLE CARDS ***
ChrisChamber: folds
orbcrazyk: raises $1 to $1.50
DerFlotti: folds
Axelll51: calls $1
*** FLOP *** [Ah 5s 7s]
Axelll51: checks
orbcrazyk: checks
*** TURN *** [Ah 5s 7s] [Ac]
Axelll51: checks
orbcrazyk: checks
*** RIVER *** [Ah 5s 7s Ac] [7c]
Axelll51: checks
orbcrazyk: checks
*** SHOW DOWN ***
Axelll51: shows [3s 2s] (two pair, Aces and Sevens)
orbcrazyk: shows [Ts Jh] (two pair, Aces and Sevens - Jack kicker)
orbcrazyk collected $3.09 from pot
*** SUMMARY ***
Total pot $3.25 | Rake $0.16
Board [Ah 5s 7s Ac 7c]
Seat 2: orbcrazyk (button) showed [Ts Jh] and won ($3.09) with two pair, Aces and Sevens
Seat 4: DerFlotti (small blind) folded before Flop
Seat 5: Axelll51 (big blind) showed [3s 2s] and lost with two pair, Aces and Sevens
Seat 6: ChrisChamber folded before Flop (didn't bet)


PokerStars Hand #208975857565:  Hold'em No Limit ($0.25/$0.50 USD) - 2020/02/08 11:19:23 ET
Table 'Acamar V' 6-max Seat #6 is the button
Seat 2: orbcrazyk ($50.25 in chips)
Seat 4: DerFlotti ($50.45 in chips)
Seat 5: Axelll51 ($26.46 in chips)
Seat 6: ChrisChamber ($52.36 in chips)
genie-kl leaves the table
orbcrazyk: posts small blind $0.25
DerFlotti: posts big blind $0.50
*** HOLE CARDS ***
Axelll51: calls $0.50
ChrisChamber: folds
orbcrazyk: raises $1.50 to $2
DerFlotti: folds
Axelll51: calls $1.50
*** FLOP *** [Qc 8c Jc]
orbcrazyk: bets $3.42
Axelll51: folds
Uncalled bet ($3.42) returned to orbcrazyk
orbcrazyk collected $4.28 from pot
orbcrazyk: doesn't show hand
*** SUMMARY ***
Total pot $4.50 | Rake $0.22
Board [Qc 8c Jc]
Seat 2: orbcrazyk (small blind) collected ($4.28)
Seat 4: DerFlotti (big blind) folded before Flop
Seat 5: Axelll51 folded on the Flop
Seat 6: ChrisChamber (button) folded before Flop (didn't bet)


PokerStars Hand #208975905698:  Hold'em No Limit ($0.25/$0.50 USD) - 2020/02/08 11:20:50 ET
Table 'Acamar V' 6-max Seat #6 is the button
Seat 3: olo0olo ($50 in chips)
Seat 4: DerFlotti ($71.91 in chips)
Seat 6: Soydemimami ($50 in chips)
olo0olo: posts small blind $0.25
DerFlotti: posts big blind $0.50
*** HOLE CARDS ***
Soydemimami: raises $0.50 to $1
olo0olo: folds
DerFlotti: folds
Uncalled bet ($0.50) returned to Soydemimami
Soydemimami collected $1.25 from pot
*** SUMMARY ***
Total pot $1.25 | Rake $0
Seat 3: olo0olo (small blind) folded before Flop
Seat 4: DerFlotti (big blind) folded before Flop
Seat 6: Soydemimami (button) collected ($1.25)


PokerStars Hand #208975943153:  Hold'em No Limit ($0.25/$0.50 USD) - 2020/02/08 11:22:00 ET
Table 'Acamar V' 6-max Seat #4 is the button
Seat 3: olo0olo ($50 in chips)
Seat 4: DerFlotti ($71.16 in chips)
Seat 6: Soydemimami ($55.26 in chips)
Soydemimami: posts small blind $0.25
olo0olo: posts big blind $0.50
*** HOLE CARDS ***
DerFlotti: raises $1 to $1.50
Soydemimami: folds
olo0olo: raises $3.50 to $5
DerFlotti: folds
Uncalled bet ($3.50) returned to olo0olo
olo0olo collected $3.25 from pot
olo0olo: doesn't show hand
*** SUMMARY ***
Total pot $3.25 | Rake $0
Seat 3: olo0olo (big blind) collected ($3.25)
Seat 4: DerFlotti (button) folded before Flop
Seat 6: Soydemimami (small blind) folded before Flop


PokerStars Hand #208975911653:  Hold'em No Limit ($0.25/$0.50 USD) - 2020/02/08 11:21:02 ET
Table 'Acamar V' 6-max Seat #3 is the button
Seat 3: olo0olo ($50 in chips)
Seat 4: DerFlotti ($71.41 in chips)
Seat 6: Soydemimami ($50.75 in chips)
DerFlotti: posts small blind $0.25
Soydemimami: posts big blind $0.50
*** HOLE CARDS ***
olo0olo: raises $0.60 to $1.10
DerFlotti: folds
Soydemimami: raises $3.65 to $4.75
olo0olo: calls $3.65
*** FLOP *** [Js 5d Qs]
Soydemimami: checks
olo0olo: checks
*** TURN *** [Js 5d Qs] [7h]
Soydemimami: checks
olo0olo: checks
*** RIVER *** [Js 5d Qs 7h] [Jh]
Soydemimami: bets $7
olo0olo: folds
Uncalled bet ($7) returned to Soydemimami
Soydemimami collected $9.26 from pot
*** SUMMARY ***
Total pot $9.75 | Rake $0.49
Board [Js 5d Qs 7h Jh]
Seat 3: olo0olo (button) folded on the River
Seat 4: DerFlotti (small blind) folded before Flop
Seat 6: Soydemimami (big blind) collected ($9.26)


PokerStars Hand #208975950883:  Hold'em No Limit ($0.25/$0.50 USD) - 2020/02/08 11:22:15 ET
Table 'Acamar V' 6-max Seat #6 is the button
Seat 3: olo0olo ($51.75 in chips)
Seat 4: DerFlotti ($69.66 in chips)
Seat 6: Soydemimami ($55.01 in chips)
olo0olo: posts small blind $0.25
DerFlotti: posts big blind $0.50
*** HOLE CARDS ***
Soydemimami: raises $0.50 to $1
olo0olo: raises $3.50 to $4.50
DerFlotti: folds
Soydemimami: folds
Uncalled bet ($3.50) returned to olo0olo
olo0olo collected $2.50 from pot
olo0olo: doesn't show hand
*** SUMMARY ***
Total pot $2.50 | Rake $0
Seat 3: olo0olo (small blind) collected ($2.50)
Seat 4: DerFlotti (big blind) folded before Flop
Seat 6: Soydemimami (button) folded before Flop


PokerStars Hand #208975989880:  Hold'em No Limit ($0.25/$0.50 USD) - 2020/02/08 11:23:12 ET
Table 'Acamar V' 6-max Seat #4 is the button
Seat 3: olo0olo ($55.25 in chips)
Seat 4: DerFlotti ($67.66 in chips)
Seat 5: Natsu PRO ($50 in chips)
Seat 6: Soydemimami ($53.90 in chips)
Natsu PRO: posts small blind $0.25
Soydemimami: posts big blind $0.50
ilaviiitech: sits out
*** HOLE CARDS ***
olo0olo: folds
Lasch04 joins the table at seat #1
DerFlotti: folds
Natsu PRO: folds
Uncalled bet ($0.25) returned to Soydemimami
Soydemimami collected $0.50 from pot
*** SUMMARY ***
Total pot $0.50 | Rake $0
Seat 3: olo0olo folded before Flop (didn't bet)
Seat 4: DerFlotti (button) folded before Flop (didn't bet)
Seat 5: Natsu PRO (small blind) folded before Flop
Seat 6: Soydemimami (big blind) collected ($0.50)


PokerStars Hand #208975984248:  Hold'em No Limit ($0.25/$0.50 USD) - 2020/02/08 11:23:01 ET
Table 'Acamar V' 6-max Seat #3 is the button
Seat 3: olo0olo ($53.25 in chips)
Seat 4: DerFlotti ($67.91 in chips)
Seat 5: Natsu PRO ($50 in chips)
Seat 6: Soydemimami ($55.15 in chips)
DerFlotti: posts small blind $0.25
Natsu PRO: posts big blind $0.50
ilaviiitech: sits out
*** HOLE CARDS ***
Soydemimami: raises $0.75 to $1.25
olo0olo: raises $3.25 to $4.50
DerFlotti: folds
Natsu PRO: folds
Soydemimami: folds
Uncalled bet ($3.25) returned to olo0olo
olo0olo collected $3.25 from pot
olo0olo: doesn't show hand
*** SUMMARY ***
Total pot $3.25 | Rake $0
Seat 3: olo0olo (button) collected ($3.25)
Seat 4: DerFlotti (small blind) folded before Flop
Seat 5: Natsu PRO (big blind) folded before Flop
Seat 6: Soydemimami folded before Flop


PokerStars Hand #208975975401:  Hold'em No Limit ($0.25/$0.50 USD) - 2020/02/08 11:22:44 ET
Table 'Acamar V' 6-max Seat #6 is the button
Seat 3: olo0olo ($53.50 in chips)
Seat 4: DerFlotti ($68.91 in chips)
Seat 6: Soydemimami ($54.01 in chips)
olo0olo: posts small blind $0.25
DerFlotti: posts big blind $0.50
*** HOLE CARDS ***
Soydemimami: raises $0.50 to $1
olo0olo: folds
DerFlotti: calls $0.50
*** FLOP *** [Ts 4s 9h]
Emily_GetMan leaves the table
DerFlotti: checks
Soydemimami: bets $0.71
Natsu PRO joins the table at seat #5
DerFlotti: folds
Uncalled bet ($0.71) returned to Soydemimami
Fart8725 leaves the table
Soydemimami collected $2.14 from pot
*** SUMMARY ***
Total pot $2.25 | Rake $0.11
Board [Ts 4s 9h]
Seat 3: olo0olo (small blind) folded before Flop
Seat 4: DerFlotti (big blind) folded on the Flop
Seat 6: Soydemimami (button) collected ($2.14)


PokerStars Hand #208975970548:  Hold'em No Limit ($0.25/$0.50 USD) - 2020/02/08 11:22:35 ET
Table 'Acamar V' 6-max Seat #4 is the button
Seat 3: olo0olo ($54 in chips)
Seat 4: DerFlotti ($68.91 in chips)
Seat 6: Soydemimami ($53.51 in chips)
Fart8725 joins the table at seat #1
Soydemimami: posts small blind $0.25
olo0olo: posts big blind $0.50
*** HOLE CARDS ***
DerFlotti: folds
ilaviiitech joins the table at seat #2
Soydemimami: raises $1 to $1.50
Emily_GetMan joins the table at seat #5
olo0olo: folds
Uncalled bet ($1) returned to Soydemimami
Soydemimami collected $1 from pot
*** SUMMARY ***
Total pot $1 | Rake $0
Seat 3: olo0olo (big blind) folded before Flop
Seat 4: DerFlotti (button) folded before Flop (didn't bet)
Seat 6: Soydemimami (small blind) collected ($1)


PokerStars Hand #208975965931:  Hold'em No Limit ($0.25/$0.50 USD) - 2020/02/08 11:22:26 ET
Table 'Acamar V' 6-max Seat #3 is the button
Seat 3: olo0olo ($53.25 in chips)
Seat 4: DerFlotti ($69.16 in chips)
Seat 6: Soydemimami ($54.01 in chips)
DerFlotti: posts small blind $0.25
Soydemimami: posts big blind $0.50
*** HOLE CARDS ***
olo0olo: raises $0.60 to $1.10
DerFlotti: folds
Soydemimami: folds
Uncalled bet ($0.60) returned to olo0olo
olo0olo collected $1.25 from pot
olo0olo: doesn't show hand
*** SUMMARY ***
Total pot $1.25 | Rake $0
Seat 3: olo0olo (button) collected ($1.25)
Seat 4: DerFlotti (small blind) folded before Flop
Seat 6: Soydemimami (big blind) folded before Flop


PokerStars Hand #208975994040:  Hold'em No Limit ($0.25/$0.50 USD) - 2020/02/08 11:23:20 ET
Table 'Acamar V' 6-max Seat #5 is the button
Seat 1: Lasch04 ($50 in chips)
Seat 3: olo0olo ($55.25 in chips)
Seat 4: DerFlotti ($67.66 in chips)
Seat 5: Natsu PRO ($50 in chips)
Seat 6: Soydemimami ($54.15 in chips)
Soydemimami: posts small blind $0.25
Lasch04: posts big blind $0.50
ilaviiitech: sits out
*** HOLE CARDS ***
olo0olo: folds
DerFlotti: folds
Natsu PRO: folds
Soydemimami: raises $1 to $1.50
Lasch04: folds
Uncalled bet ($1) returned to Soydemimami
Soydemimami collected $1 from pot
*** SUMMARY ***
Total pot $1 | Rake $0
Seat 1: Lasch04 (big blind) folded before Flop
Seat 3: olo0olo folded before Flop (didn't bet)
Seat 4: DerFlotti folded before Flop (didn't bet)
Seat 5: Natsu PRO (button) folded before Flop (didn't bet)
Seat 6: Soydemimami (small blind) collected ($1)


PokerStars Hand #208976015739:  Hold'em No Limit ($0.25/$0.50 USD) - 2020/02/08 11:24:00 ET
Table 'Acamar V' 6-max Seat #1 is the button
Seat 1: Lasch04 ($48 in chips)
Seat 2: ilaviiitech ($50 in chips)
Seat 3: olo0olo ($55.25 in chips)
Seat 4: DerFlotti ($67.66 in chips)
Seat 5: Natsu PRO ($51.82 in chips)
Seat 6: Soydemimami ($54.65 in chips)
ilaviiitech: posts small blind $0.25
olo0olo: posts big blind $0.50
*** HOLE CARDS ***
DerFlotti: folds
Natsu PRO: folds
Soydemimami: folds
Lasch04: folds
ilaviiitech: folds
Uncalled bet ($0.25) returned to olo0olo
olo0olo collected $0.50 from pot
olo0olo: doesn't show hand
*** SUMMARY ***
Total pot $0.50 | Rake $0
Seat 1: Lasch04 (button) folded before Flop (didn't bet)
Seat 2: ilaviiitech (small blind) folded before Flop
Seat 3: olo0olo (big blind) collected ($0.50)
Seat 4: DerFlotti folded before Flop (didn't bet)
Seat 5: Natsu PRO folded before Flop (didn't bet)
Seat 6: Soydemimami folded before Flop (didn't bet)


PokerStars Hand #208976000758:  Hold'em No Limit ($0.25/$0.50 USD) - 2020/02/08 11:23:32 ET
Table 'Acamar V' 6-max Seat #6 is the button
Seat 1: Lasch04 ($49.50 in chips)
Seat 2: ilaviiitech ($50 in chips)
Seat 3: olo0olo ($55.25 in chips)
Seat 4: DerFlotti ($67.66 in chips)
Seat 5: Natsu PRO ($50 in chips)
Seat 6: Soydemimami ($54.65 in chips)
Lasch04: posts small blind $0.25
ilaviiitech: posts big blind $0.50
*** HOLE CARDS ***
olo0olo: folds
DerFlotti: folds
Natsu PRO: raises $1 to $1.50
Soydemimami: folds
Lasch04: calls $1.25
ilaviiitech: folds
*** FLOP *** [8d 3d 5s]
Lasch04: checks
Natsu PRO: bets $2.19
Lasch04: folds
Uncalled bet ($2.19) returned to Natsu PRO
Natsu PRO collected $3.32 from pot
Natsu PRO: doesn't show hand
*** SUMMARY ***
Total pot $3.50 | Rake $0.18
Board [8d 3d 5s]
Seat 1: Lasch04 (small blind) folded on the Flop
Seat 2: ilaviiitech (big blind) folded before Flop
Seat 3: olo0olo folded before Flop (didn't bet)
Seat 4: DerFlotti folded before Flop (didn't bet)
Seat 5: Natsu PRO collected ($3.32)
Seat 6: Soydemimami (button) folded before Flop (didn't bet)


PokerStars Hand #208976021219:  Hold'em No Limit ($0.25/$0.50 USD) - 2020/02/08 11:24:10 ET
Table 'Acamar V' 6-max Seat #2 is the button
Seat 1: Lasch04 ($48 in chips)
Seat 2: ilaviiitech ($50 in chips)
Seat 3: olo0olo ($55.50 in chips)
Seat 4: DerFlotti ($67.66 in chips)
Seat 5: Natsu PRO ($51.82 in chips)
Seat 6: Soydemimami ($54.65 in chips)
olo0olo: posts small blind $0.25
DerFlotti: posts big blind $0.50
*** HOLE CARDS ***
Natsu PRO: raises $0.70 to $1.20
Soydemimami: folds
Lasch04: calls $1.20
ilaviiitech: raises $4.30 to $5.50
olo0olo: folds
DerFlotti: folds
Natsu PRO: calls $4.30
Lasch04: folds
*** FLOP *** [Kh 6d 9d]
Natsu PRO: checks
ilaviiitech: bets $6.77
Natsu PRO: folds
Uncalled bet ($6.77) returned to ilaviiitech
ilaviiitech collected $12.30 from pot
ilaviiitech: doesn't show hand
*** SUMMARY ***
Total pot $12.95 | Rake $0.65
Board [Kh 6d 9d]
Seat 1: Lasch04 folded before Flop
Seat 2: ilaviiitech (button) collected ($12.30)
Seat 3: olo0olo (small blind) folded before Flop
Seat 4: DerFlotti (big blind) folded before Flop
Seat 5: Natsu PRO folded on the Flop
Seat 6: Soydemimami folded before Flop (didn't bet)


PokerStars Hand #208976082232:  Hold'em No Limit ($0.25/$0.50 USD) - 2020/02/08 11:26:05 ET
Table 'Acamar V' 6-max Seat #4 is the button
Seat 1: Lasch04 ($30.55 in chips)
Seat 2: ilaviiitech ($55.30 in chips)
Seat 3: olo0olo ($55.25 in chips)
Seat 4: DerFlotti ($66.91 in chips)
Seat 6: Soydemimami ($70.94 in chips)
Soydemimami: posts small blind $0.25
Lasch04: posts big blind $0.50
*** HOLE CARDS ***
ilaviiitech: raises $0.78 to $1.28
olo0olo: folds
DerFlotti: folds
Soydemimami: folds
Lasch04: calls $0.78
*** FLOP *** [2s Jd 5c]
Lasch04: checks
ilaviiitech: bets $1.60
Lasch04: folds
Uncalled bet ($1.60) returned to ilaviiitech
ilaviiitech collected $2.67 from pot
ilaviiitech: doesn't show hand
*** SUMMARY ***
Total pot $2.81 | Rake $0.14
Board [2s Jd 5c]
Seat 1: Lasch04 (big blind) folded on the Flop
Seat 2: ilaviiitech collected ($2.67)
Seat 3: olo0olo folded before Flop (didn't bet)
Seat 4: DerFlotti (button) folded before Flop (didn't bet)
Seat 6: Soydemimami (small blind) folded before Flop


PokerStars Hand #208976042579:  Hold'em No Limit ($0.25/$0.50 USD) - 2020/02/08 11:24:51 ET
Table 'Acamar V' 6-max Seat #3 is the button
Seat 1: Lasch04 ($46.80 in chips)
Seat 2: ilaviiitech ($56.80 in chips)
Seat 3: olo0olo ($55.25 in chips)
Seat 4: DerFlotti ($67.16 in chips)
Seat 6: Soydemimami ($54.65 in chips)
DerFlotti: posts small blind $0.25
Natsu PRO: is sitting out
Soydemimami: posts big blind $0.50
*** HOLE CARDS ***
Lasch04: raises $1 to $1.50
ilaviiitech: calls $1.50
Natsu PRO leaves the table
G.HANSEN333 joins the table at seat #5
olo0olo: folds
DerFlotti: folds
Soydemimami: calls $1
*** FLOP *** [7s Ad 9s]
Soydemimami: checks
Lasch04: bets $2
ilaviiitech: folds
Soydemimami: raises $5.75 to $7.75
Lasch04: calls $5.75
*** TURN *** [7s Ad 9s] [9h]
Soydemimami: bets $7
Lasch04: calls $7
*** RIVER *** [7s Ad 9s 9h] [2s]
Soydemimami: bets $30.75
Lasch04: folds
Uncalled bet ($30.75) returned to Soydemimami
Soydemimami collected $32.54 from pot
*** SUMMARY ***
Total pot $34.25 | Rake $1.71
Board [7s Ad 9s 9h 2s]
Seat 1: Lasch04 folded on the River
Seat 2: ilaviiitech folded on the Flop
Seat 3: olo0olo (button) folded before Flop (didn't bet)
Seat 4: DerFlotti (small blind) folded before Flop
Seat 6: Soydemimami (big blind) collected ($32.54)


PokerStars Hand #208976092216:  Hold'em No Limit ($0.25/$0.50 USD) - 2020/02/08 11:26:23 ET
Table 'Acamar V' 6-max Seat #6 is the button
Seat 1: Lasch04 ($29.27 in chips)
Seat 3: olo0olo ($55.25 in chips)
Seat 4: DerFlotti ($66.91 in chips)
Seat 6: Soydemimami ($70.69 in chips)
Lasch04: posts small blind $0.25
ilaviiitech: is sitting out
olo0olo: posts big blind $0.50
G.HANSEN333: sits out
*** HOLE CARDS ***
DerFlotti: folds
ilaviiitech leaves the table
Soydemimami: raises $0.50 to $1
Lasch04: calls $0.75
olo0olo: folds
*** FLOP *** [Ad Jd 8h]
Lasch04: checks
Soydemimami: bets $0.60
Lasch04: folds
Uncalled bet ($0.60) returned to Soydemimami
Soydemimami collected $2.38 from pot
*** SUMMARY ***
Total pot $2.50 | Rake $0.12
Board [Ad Jd 8h]
Seat 1: Lasch04 (small blind) folded on the Flop
Seat 3: olo0olo (big blind) folded before Flop
Seat 4: DerFlotti folded before Flop (didn't bet)
Seat 6: Soydemimami (button) collected ($2.38)


PokerStars Hand #208976103372:  Hold'em No Limit ($0.25/$0.50 USD) - 2020/02/08 11:26:44 ET
Table 'Acamar V' 6-max Seat #1 is the button
Seat 1: Lasch04 ($28.27 in chips)
Seat 3: olo0olo ($54.75 in chips)
Seat 4: DerFlotti ($66.91 in chips)
Seat 6: Soydemimami ($72.07 in chips)
olo0olo: posts small blind $0.25
DerFlotti: posts big blind $0.50
G.HANSEN333: sits out
*** HOLE CARDS ***
Soydemimami: folds
Lasch04: folds
olo0olo: folds
Uncalled bet ($0.25) returned to DerFlotti
DerFlotti collected $0.50 from pot
DerFlotti: doesn't show hand
*** SUMMARY ***
Total pot $0.50 | Rake $0
Seat 1: Lasch04 (button) folded before Flop (didn't bet)
Seat 3: olo0olo (small blind) folded before Flop
Seat 4: DerFlotti (big blind) collected ($0.50)
Seat 6: Soydemimami folded before Flop (didn't bet)


PokerStars Hand #208976110794:  Hold'em No Limit ($0.25/$0.50 USD) - 2020/02/08 11:26:58 ET
Table 'Acamar V' 6-max Seat #3 is the button
Seat 1: Lasch04 ($28.27 in chips)
Seat 3: olo0olo ($54.50 in chips)
Seat 4: DerFlotti ($67.16 in chips)
Seat 5: G.HANSEN333 ($50 in chips)
Seat 6: Soydemimami ($72.07 in chips)
DerFlotti: posts small blind $0.25
G.HANSEN333: posts big blind $0.50
*** HOLE CARDS ***
Sack444 joins the table at seat #2
Soydemimami: folds
Lasch04: raises $1 to $1.50
olo0olo: folds
DerFlotti: folds
G.HANSEN333: folds
Uncalled bet ($1) returned to Lasch04
Lasch04 collected $1.25 from pot
Lasch04: doesn't show hand
*** SUMMARY ***
Total pot $1.25 | Rake $0
Seat 1: Lasch04 collected ($1.25)
Seat 3: olo0olo (button) folded before Flop (didn't bet)
Seat 4: DerFlotti (small blind) folded before Flop
Seat 5: G.HANSEN333 (big blind) folded before Flop
Seat 6: Soydemimami folded before Flop (didn't bet)


PokerStars Hand #208976120649:  Hold'em No Limit ($0.25/$0.50 USD) - 2020/02/08 11:27:13 ET
Table 'Acamar V' 6-max Seat #4 is the button
Seat 1: Lasch04 ($29.02 in chips)
Seat 3: olo0olo ($54.50 in chips)
Seat 4: DerFlotti ($66.91 in chips)
Seat 5: G.HANSEN333 ($50 in chips)
Seat 6: Soydemimami ($72.07 in chips)
G.HANSEN333: posts small blind $0.25
Soydemimami: posts big blind $0.50
Sack444: sits out
*** HOLE CARDS ***
Lasch04: folds
olo0olo: raises $0.60 to $1.10
DerFlotti: folds
G.HANSEN333: folds
Soydemimami: folds
Uncalled bet ($0.60) returned to olo0olo
olo0olo collected $1.25 from pot
olo0olo: doesn't show hand
*** SUMMARY ***
Total pot $1.25 | Rake $0
Seat 1: Lasch04 folded before Flop (didn't bet)
Seat 3: olo0olo collected ($1.25)
Seat 4: DerFlotti (button) folded before Flop (didn't bet)
Seat 5: G.HANSEN333 (small blind) folded before Flop
Seat 6: Soydemimami (big blind) folded before Flop


PokerStars Hand #208976127457:  Hold'em No Limit ($0.25/$0.50 USD) - 2020/02/08 11:27:26 ET
Table 'Acamar V' 6-max Seat #5 is the button
Seat 1: Lasch04 ($29.02 in chips)
Seat 3: olo0olo ($55.25 in chips)
Seat 4: DerFlotti ($66.91 in chips)
Seat 5: G.HANSEN333 ($50 in chips)
Seat 6: Soydemimami ($71.57 in chips)
Soydemimami: posts small blind $0.25
Lasch04: posts big blind $0.50
Sack444: sits out
*** HOLE CARDS ***
olo0olo: raises $0.60 to $1.10
DerFlotti: calls $1.10
G.HANSEN333: folds
Soydemimami: folds
Lasch04: calls $0.60
*** FLOP *** [5h 2h 2c]
Lasch04: checks
olo0olo: checks
DerFlotti: bets $2
Lasch04: folds
olo0olo: calls $2
*** TURN *** [5h 2h 2c] [Kh]
olo0olo: checks
DerFlotti: checks
*** RIVER *** [5h 2h 2c Kh] [6s]
olo0olo: bets $5.52
DerFlotti: folds
Uncalled bet ($5.52) returned to olo0olo
olo0olo collected $7.17 from pot
olo0olo: doesn't show hand
*** SUMMARY ***
Total pot $7.55 | Rake $0.38
Board [5h 2h 2c Kh 6s]
Seat 1: Lasch04 (big blind) folded on the Flop
Seat 3: olo0olo collected ($7.17)
Seat 4: DerFlotti folded on the River
Seat 5: G.HANSEN333 (button) folded before Flop (didn't bet)
Seat 6: Soydemimami (small blind) folded before Flop


PokerStars Hand #208976168174:  Hold'em No Limit ($0.25/$0.50 USD) - 2020/02/08 11:28:43 ET
Table 'Acamar V' 6-max Seat #1 is the button
Seat 1: Lasch04 ($27.67 in chips)
Seat 2: Sack444 ($48.90 in chips)
Seat 3: olo0olo ($61.59 in chips)
Seat 4: DerFlotti ($63.81 in chips)
Seat 5: G.HANSEN333 ($50 in chips)
Seat 6: Soydemimami ($70.22 in chips)
Sack444: posts small blind $0.25
olo0olo: posts big blind $0.50
*** HOLE CARDS ***
DerFlotti: folds
G.HANSEN333: raises $0.75 to $1.25
Soydemimami: folds
Lasch04: folds
Sack444: folds
olo0olo: folds
Uncalled bet ($0.75) returned to G.HANSEN333
G.HANSEN333 collected $1.25 from pot
G.HANSEN333: doesn't show hand
*** SUMMARY ***
Total pot $1.25 | Rake $0
Seat 1: Lasch04 (button) folded before Flop (didn't bet)
Seat 2: Sack444 (small blind) folded before Flop
Seat 3: olo0olo (big blind) folded before Flop
Seat 4: DerFlotti folded before Flop (didn't bet)
Seat 5: G.HANSEN333 collected ($1.25)
Seat 6: Soydemimami folded before Flop (didn't bet)


PokerStars Hand #208976157156:  Hold'em No Limit ($0.25/$0.50 USD) - 2020/02/08 11:28:22 ET
Table 'Acamar V' 6-max Seat #6 is the button
Seat 1: Lasch04 ($27.92 in chips)
Seat 2: Sack444 ($50 in chips)
Seat 3: olo0olo ($59.32 in chips)
Seat 4: DerFlotti ($63.81 in chips)
Seat 5: G.HANSEN333 ($50 in chips)
Seat 6: Soydemimami ($71.32 in chips)
Lasch04: posts small blind $0.25
Sack444: posts big blind $0.50
*** HOLE CARDS ***
olo0olo: raises $0.60 to $1.10
DerFlotti: folds
G.HANSEN333: folds
Soydemimami: calls $1.10
Lasch04: folds
Sack444: calls $0.60
*** FLOP *** [7d Kc Js]
Sack444: checks
olo0olo: bets $1.11
Soydemimami: folds
Sack444: folds
Uncalled bet ($1.11) returned to olo0olo
olo0olo collected $3.37 from pot
olo0olo: doesn't show hand
*** SUMMARY ***
Total pot $3.55 | Rake $0.18
Board [7d Kc Js]
Seat 1: Lasch04 (small blind) folded before Flop
Seat 2: Sack444 (big blind) folded on the Flop
Seat 3: olo0olo collected ($3.37)
Seat 4: DerFlotti folded before Flop (didn't bet)
Seat 5: G.HANSEN333 folded before Flop (didn't bet)
Seat 6: Soydemimami (button) folded on the Flop


PokerStars Hand #208976177241:  Hold'em No Limit ($0.25/$0.50 USD) - 2020/02/08 11:29:00 ET
Table 'Acamar V' 6-max Seat #2 is the button
Seat 1: Lasch04 ($27.67 in chips)
Seat 2: Sack444 ($48.65 in chips)
Seat 3: olo0olo ($61.09 in chips)
Seat 4: DerFlotti ($63.81 in chips)
Seat 5: G.HANSEN333 ($50.75 in chips)
Seat 6: Soydemimami ($70.22 in chips)
olo0olo: posts small blind $0.25
DerFlotti: posts big blind $0.50
*** HOLE CARDS ***
G.HANSEN333: folds
Soydemimami: raises $0.75 to $1.25
Lasch04: calls $1.25
Sack444: calls $1.25
olo0olo: folds
DerFlotti: calls $0.75
*** FLOP *** [9c 2c 9h]
DerFlotti: checks
Soydemimami: checks
Lasch04: checks
Sack444: bets $3.50
DerFlotti: calls $3.50
Soydemimami: folds
Lasch04: folds
*** TURN *** [9c 2c 9h] [Jd]
DerFlotti: checks
Sack444: checks
*** RIVER *** [9c 2c 9h Jd] [5c]
DerFlotti: bets $6.50
Sack444: folds
Uncalled bet ($6.50) returned to DerFlotti
DerFlotti collected $11.64 from pot
DerFlotti: doesn't show hand
*** SUMMARY ***
Total pot $12.25 | Rake $0.61
Board [9c 2c 9h Jd 5c]
Seat 1: Lasch04 folded on the Flop
Seat 2: Sack444 (button) folded on the River
Seat 3: olo0olo (small blind) folded before Flop
Seat 4: DerFlotti (big blind) collected ($11.64)
Seat 5: G.HANSEN333 folded before Flop (didn't bet)
Seat 6: Soydemimami folded on the Flop


PokerStars Hand #208976228454:  Hold'em No Limit ($0.25/$0.50 USD) - 2020/02/08 11:30:35 ET
Table 'Acamar V' 6-max Seat #4 is the button
Seat 1: Lasch04 ($28.24 in chips)
Seat 2: Sack444 ($43.90 in chips)
Seat 3: olo0olo ($60.84 in chips)
Seat 4: DerFlotti ($69.20 in chips)
Seat 5: G.HANSEN333 ($50.25 in chips)
Seat 6: Soydemimami ($68.97 in chips)
G.HANSEN333: posts small blind $0.25
Soydemimami: posts big blind $0.50
*** HOLE CARDS ***
Lasch04: raises $1 to $1.50
Sack444: folds
olo0olo: folds
DerFlotti: folds
G.HANSEN333: folds
Soydemimami: calls $1
*** FLOP *** [6c Ac 6h]
Soydemimami: checks
Lasch04: checks
*** TURN *** [6c Ac 6h] [2d]
Soydemimami: checks
Lasch04: checks
*** RIVER *** [6c Ac 6h 2d] [8c]
Soydemimami: checks
Lasch04: bets $1.55
Soydemimami: folds
Uncalled bet ($1.55) returned to Lasch04
Lasch04 collected $3.09 from pot
Lasch04: doesn't show hand
*** SUMMARY ***
Total pot $3.25 | Rake $0.16
Board [6c Ac 6h 2d 8c]
Seat 1: Lasch04 collected ($3.09)
Seat 2: Sack444 folded before Flop (didn't bet)
Seat 3: olo0olo folded before Flop (didn't bet)
Seat 4: DerFlotti (button) folded before Flop (didn't bet)
Seat 5: G.HANSEN333 (small blind) folded before Flop
Seat 6: Soydemimami (big blind) folded on the River


PokerStars Hand #208976208596:  Hold'em No Limit ($0.25/$0.50 USD) - 2020/02/08 11:29:59 ET
Table 'Acamar V' 6-max Seat #3 is the button
Seat 1: Lasch04 ($26.42 in chips)
Seat 2: Sack444 ($43.90 in chips)
Seat 3: olo0olo ($60.84 in chips)
Seat 4: DerFlotti ($70.70 in chips)
Seat 5: G.HANSEN333 ($50.75 in chips)
Seat 6: Soydemimami ($68.97 in chips)
DerFlotti: posts small blind $0.25
G.HANSEN333: posts big blind $0.50
*** HOLE CARDS ***
Soydemimami: folds
Lasch04: raises $1 to $1.50
Sack444: folds
olo0olo: folds
DerFlotti: calls $1.25
G.HANSEN333: folds
*** FLOP *** [7d 3c Kd]
DerFlotti: checks
Lasch04: checks
*** TURN *** [7d 3c Kd] [2d]
DerFlotti: checks
Lasch04: checks
*** RIVER *** [7d 3c Kd 2d] [Ah]
DerFlotti: checks
Lasch04: bets $1.66
DerFlotti: folds
Uncalled bet ($1.66) returned to Lasch04
Lasch04 collected $3.32 from pot
Lasch04: doesn't show hand
*** SUMMARY ***
Total pot $3.50 | Rake $0.18
Board [7d 3c Kd 2d Ah]
Seat 1: Lasch04 collected ($3.32)
Seat 2: Sack444 folded before Flop (didn't bet)
Seat 3: olo0olo (button) folded before Flop (didn't bet)
Seat 4: DerFlotti (small blind) folded on the River
Seat 5: G.HANSEN333 (big blind) folded before Flop
Seat 6: Soydemimami folded before Flop (didn't bet)


PokerStars Hand #208976262512:  Hold'em No Limit ($0.25/$0.50 USD) - 2020/02/08 11:31:39 ET
Table 'Acamar V' 6-max Seat #6 is the button
Seat 1: Lasch04 ($29.33 in chips)
Seat 2: Sack444 ($42.40 in chips)
Seat 3: olo0olo ($60.84 in chips)
Seat 4: DerFlotti ($71.45 in chips)
Seat 5: G.HANSEN333 ($50 in chips)
Seat 6: Soydemimami ($67.22 in chips)
Lasch04: posts small blind $0.25
Sack444: posts big blind $0.50
*** HOLE CARDS ***
olo0olo: folds
DerFlotti: folds
G.HANSEN333: folds
Soydemimami: folds
Lasch04: folds
Uncalled bet ($0.25) returned to Sack444
Sack444 collected $0.50 from pot
Sack444: doesn't show hand
*** SUMMARY ***
Total pot $0.50 | Rake $0
Seat 1: Lasch04 (small blind) folded before Flop
Seat 2: Sack444 (big blind) collected ($0.50)
Seat 3: olo0olo folded before Flop (didn't bet)
Seat 4: DerFlotti folded before Flop (didn't bet)
Seat 5: G.HANSEN333 folded before Flop (didn't bet)
Seat 6: Soydemimami (button) folded before Flop (didn't bet)


PokerStars Hand #208976270466:  Hold'em No Limit ($0.25/$0.50 USD) - 2020/02/08 11:31:54 ET
Table 'Acamar V' 6-max Seat #1 is the button
Seat 1: Lasch04 ($29.08 in chips)
Seat 2: Sack444 ($42.65 in chips)
Seat 3: olo0olo ($60.84 in chips)
Seat 4: DerFlotti ($71.45 in chips)
Seat 5: G.HANSEN333 ($50 in chips)
Seat 6: Soydemimami ($67.22 in chips)
Sack444: posts small blind $0.25
olo0olo: posts big blind $0.50
*** HOLE CARDS ***
DerFlotti: folds
G.HANSEN333: raises $0.75 to $1.25
Soydemimami: folds
Lasch04: folds
Sack444: folds
olo0olo: folds
Uncalled bet ($0.75) returned to G.HANSEN333
G.HANSEN333 collected $1.25 from pot
G.HANSEN333: doesn't show hand
*** SUMMARY ***
Total pot $1.25 | Rake $0
Seat 1: Lasch04 (button) folded before Flop (didn't bet)
Seat 2: Sack444 (small blind) folded before Flop
Seat 3: olo0olo (big blind) folded before Flop
Seat 4: DerFlotti folded before Flop (didn't bet)
Seat 5: G.HANSEN333 collected ($1.25)
Seat 6: Soydemimami folded before Flop (didn't bet)


PokerStars Hand #208976280398:  Hold'em No Limit ($0.25/$0.50 USD) - 2020/02/08 11:32:13 ET
Table 'Acamar V' 6-max Seat #2 is the button
Seat 1: Lasch04 ($29.08 in chips)
Seat 2: Sack444 ($42.40 in chips)
Seat 3: olo0olo ($60.34 in chips)
Seat 4: DerFlotti ($71.45 in chips)
Seat 5: G.HANSEN333 ($50.75 in chips)
Seat 6: Soydemimami ($67.22 in chips)
olo0olo: posts small blind $0.25
DerFlotti: posts big blind $0.50
*** HOLE CARDS ***
G.HANSEN333: folds
Soydemimami: folds
G.HANSEN333 leaves the table
Lasch04: raises $1 to $1.50
Sack444: folds
olo0olo: folds
DerFlotti: folds
Uncalled bet ($1) returned to Lasch04
Lasch04 collected $1.25 from pot
Lasch04: doesn't show hand
*** SUMMARY ***
Total pot $1.25 | Rake $0
Seat 1: Lasch04 collected ($1.25)
Seat 2: Sack444 (button) folded before Flop (didn't bet)
Seat 3: olo0olo (small blind) folded before Flop
Seat 4: DerFlotti (big blind) folded before Flop
Seat 5: G.HANSEN333 folded before Flop (didn't bet)
Seat 6: Soydemimami folded before Flop (didn't bet)


PokerStars Hand #208976251580:  Hold'em No Limit ($0.25/$0.50 USD) - 2020/02/08 11:31:19 ET
Table 'Acamar V' 6-max Seat #5 is the button
Seat 1: Lasch04 ($29.83 in chips)
Seat 2: Sack444 ($43.90 in chips)
Seat 3: olo0olo ($60.84 in chips)
Seat 4: DerFlotti ($69.20 in chips)
Seat 5: G.HANSEN333 ($50 in chips)
Seat 6: Soydemimami ($67.47 in chips)
Soydemimami: posts small blind $0.25
Lasch04: posts big blind $0.50
*** HOLE CARDS ***
Sack444: raises $1 to $1.50
olo0olo: folds
DerFlotti: raises $2.50 to $4
G.HANSEN333: folds
Soydemimami: folds
Lasch04: folds
Sack444: folds
Uncalled bet ($2.50) returned to DerFlotti
DerFlotti collected $3.75 from pot
DerFlotti: doesn't show hand
*** SUMMARY ***
Total pot $3.75 | Rake $0
Seat 1: Lasch04 (big blind) folded before Flop
Seat 2: Sack444 folded before Flop
Seat 3: olo0olo folded before Flop (didn't bet)
Seat 4: DerFlotti collected ($3.75)
Seat 5: G.HANSEN333 (button) folded before Flop (didn't bet)
Seat 6: Soydemimami (small blind) folded before Flop


PokerStars Hand #208976288147:  Hold'em No Limit ($0.25/$0.50 USD) - 2020/02/08 11:32:27 ET
Table 'Acamar V' 6-max Seat #3 is the button
Seat 1: Lasch04 ($29.83 in chips)
Seat 2: Sack444 ($42.40 in chips)
Seat 3: olo0olo ($60.09 in chips)
Seat 4: DerFlotti ($70.95 in chips)
Seat 6: Soydemimami ($67.22 in chips)
DerFlotti: posts small blind $0.25
Soydemimami: posts big blind $0.50
*** HOLE CARDS ***
Lasch04: calls $0.50
Sack444: folds
olo0olo: folds
DerFlotti: calls $0.25
Soydemimami: checks
*** FLOP *** [4d Qh 2h]
DerFlotti: checks
Soydemimami: bets $1.25
Sack444 is disconnected
Lasch04: folds
DerFlotti: calls $1.25
*** TURN *** [4d Qh 2h] [3c]
DerFlotti: checks
Soydemimami: bets $3.25
DerFlotti: calls $3.25
*** RIVER *** [4d Qh 2h 3c] [9h]
DerFlotti: checks
Soydemimami: bets $3.50
DerFlotti: calls $3.50
*** SHOW DOWN ***
Soydemimami: shows [4c Qs] (two pair, Queens and Fours)
DerFlotti: mucks hand
Soydemimami collected $16.62 from pot
*** SUMMARY ***
Total pot $17.50 | Rake $0.88
Board [4d Qh 2h 3c 9h]
Seat 1: Lasch04 folded on the Flop
Seat 2: Sack444 folded before Flop (didn't bet)
Seat 3: olo0olo (button) folded before Flop (didn't bet)
Seat 4: DerFlotti (small blind) mucked
Seat 6: Soydemimami (big blind) showed [4c Qs] and won ($16.62) with two pair, Queens and Fours


PokerStars Hand #208976315992:  Hold'em No Limit ($0.25/$0.50 USD) - 2020/02/08 11:33:18 ET
Table 'Acamar V' 6-max Seat #4 is the button
Seat 1: Lasch04 ($29.33 in chips)
Seat 2: Sack444 ($42.40 in chips)
Seat 3: olo0olo ($60.09 in chips)
Seat 4: DerFlotti ($62.45 in chips)
Seat 6: Soydemimami ($75.34 in chips)
Soydemimami: posts small blind $0.25
Lasch04: posts big blind $0.50
*** HOLE CARDS ***
Sack444: raises $1 to $1.50
olo0olo: folds
DerFlotti: folds
Soydemimami: folds
Lasch04: folds
Uncalled bet ($1) returned to Sack444
Sack444 collected $1.25 from pot
Sack444: doesn't show hand
*** SUMMARY ***
Total pot $1.25 | Rake $0
Seat 1: Lasch04 (big blind) folded before Flop
Seat 2: Sack444 collected ($1.25)
Seat 3: olo0olo folded before Flop (didn't bet)
Seat 4: DerFlotti (button) folded before Flop (didn't bet)
Seat 6: Soydemimami (small blind) folded before Flop


PokerStars Hand #208976326436:  Hold'em No Limit ($0.25/$0.50 USD) - 2020/02/08 11:33:38 ET
Table 'Acamar V' 6-max Seat #6 is the button
Seat 1: Lasch04 ($28.83 in chips)
Seat 2: Sack444 ($43.15 in chips)
Seat 3: olo0olo ($60.09 in chips)
Seat 4: DerFlotti ($62.45 in chips)
Seat 6: Soydemimami ($75.09 in chips)
Lasch04: posts small blind $0.25
Sack444: posts big blind $0.50
*** HOLE CARDS ***
NIXONJK joins the table at seat #5
olo0olo: folds
DerFlotti: folds
Soydemimami: raises $0.50 to $1
Lasch04: calls $0.75
Sack444: calls $0.50
*** FLOP *** [Kc 9h 2c]
Lasch04: checks
Sack444: checks
Soydemimami: checks
*** TURN *** [Kc 9h 2c] [6h]
NIXONJK leaves the table
Lasch04: checks
Sack444: checks
Soydemimami: checks
*** RIVER *** [Kc 9h 2c 6h] [Ad]
Lasch04: checks
Sack444: checks
Soydemimami: bets $2
Lasch04: folds
Sack444: folds
Uncalled bet ($2) returned to Soydemimami
Soydemimami collected $2.85 from pot
*** SUMMARY ***
Total pot $3 | Rake $0.15
Board [Kc 9h 2c 6h Ad]
Seat 1: Lasch04 (small blind) folded on the River
Seat 2: Sack444 (big blind) folded on the River
Seat 3: olo0olo folded before Flop (didn't bet)
Seat 4: DerFlotti folded before Flop (didn't bet)
Seat 6: Soydemimami (button) collected ($2.85)


PokerStars Hand #208976356626:  Hold'em No Limit ($0.25/$0.50 USD) - 2020/02/08 11:34:33 ET
Table 'Acamar V' 6-max Seat #2 is the button
Seat 1: Lasch04 ($27.83 in chips)
Seat 2: Sack444 ($42.65 in chips)
Seat 3: olo0olo ($59.59 in chips)
Seat 4: DerFlotti ($62.45 in chips)
Seat 6: Soydemimami ($76.94 in chips)
olo0olo: posts small blind $0.25
DerFlotti: posts big blind $0.50
*** HOLE CARDS ***
Soydemimami: raises $0.75 to $1.25
Lasch04: calls $1.25
Sack444: folds
orbcrazyk joins the table at seat #5
olo0olo: folds
DerFlotti: calls $0.75
*** FLOP *** [8c Kc 7c]
DerFlotti: checks
Soydemimami: checks
Lasch04: bets $1.50
DerFlotti: folds
Soydemimami: calls $1.50
*** TURN *** [8c Kc 7c] [Ah]
Soydemimami: checks
Lasch04: checks
*** RIVER *** [8c Kc 7c Ah] [8h]
Soydemimami: checks
Lasch04: checks
*** SHOW DOWN ***
Soydemimami: shows [Qh Qs] (two pair, Queens and Eights)
Lasch04: mucks hand
Soydemimami collected $6.65 from pot
*** SUMMARY ***
Total pot $7 | Rake $0.35
Board [8c Kc 7c Ah 8h]
Seat 1: Lasch04 mucked
Seat 2: Sack444 (button) folded before Flop (didn't bet)
Seat 3: olo0olo (small blind) folded before Flop
Seat 4: DerFlotti (big blind) folded on the Flop
Seat 6: Soydemimami showed [Qh Qs] and won ($6.65) with two pair, Queens and Eights


PokerStars Hand #208976349755:  Hold'em No Limit ($0.25/$0.50 USD) - 2020/02/08 11:34:21 ET
Table 'Acamar V' 6-max Seat #1 is the button
Seat 1: Lasch04 ($27.83 in chips)
Seat 2: Sack444 ($42.15 in chips)
Seat 3: olo0olo ($60.09 in chips)
Seat 4: DerFlotti ($62.45 in chips)
Seat 6: Soydemimami ($76.94 in chips)
Sack444: posts small blind $0.25
olo0olo: posts big blind $0.50
*** HOLE CARDS ***
DerFlotti: folds
Soydemimami: folds
Lasch04: folds
Sack444: raises $1 to $1.50
olo0olo: folds
Uncalled bet ($1) returned to Sack444
Sack444 collected $1 from pot
Sack444: doesn't show hand
*** SUMMARY ***
Total pot $1 | Rake $0
Seat 1: Lasch04 (button) folded before Flop (didn't bet)
Seat 2: Sack444 (small blind) collected ($1)
Seat 3: olo0olo (big blind) folded before Flop
Seat 4: DerFlotti folded before Flop (didn't bet)
Seat 6: Soydemimami folded before Flop (didn't bet)


PokerStars Hand #208976384414:  Hold'em No Limit ($0.25/$0.50 USD) - 2020/02/08 11:35:24 ET
Table 'Acamar V' 6-max Seat #3 is the button
Seat 1: Lasch04 ($25.08 in chips)
Seat 2: Sack444 ($42.65 in chips)
Seat 3: olo0olo ($59.34 in chips)
Seat 4: DerFlotti ($61.20 in chips)
Seat 5: orbcrazyk ($54.12 in chips)
Seat 6: Soydemimami ($80.84 in chips)
DerFlotti: posts small blind $0.25
orbcrazyk: posts big blind $0.50
*** HOLE CARDS ***
Soydemimami: folds
Lasch04: raises $1 to $1.50
Sack444: calls $1.50
olo0olo: folds
DerFlotti: folds
orbcrazyk: folds
*** FLOP *** [Td Jc Ah]
Lasch04: bets $1
Sack444: raises $2 to $3
Lasch04: raises $20.58 to $23.58 and is all-in
Sack444: folds
Uncalled bet ($20.58) returned to Lasch04
Lasch04 collected $9.26 from pot
Lasch04: doesn't show hand
*** SUMMARY ***
Total pot $9.75 | Rake $0.49
Board [Td Jc Ah]
Seat 1: Lasch04 collected ($9.26)
Seat 2: Sack444 folded on the Flop
Seat 3: olo0olo (button) folded before Flop (didn't bet)
Seat 4: DerFlotti (small blind) folded before Flop
Seat 5: orbcrazyk (big blind) folded before Flop
Seat 6: Soydemimami folded before Flop (didn't bet)


PokerStars Hand #208976422700:  Hold'em No Limit ($0.25/$0.50 USD) - 2020/02/08 11:36:35 ET
Table 'Acamar V' 6-max Seat #5 is the button
Seat 1: Lasch04 ($29.84 in chips)
Seat 2: Sack444 ($38.15 in chips)
Seat 3: olo0olo ($59.34 in chips)
Seat 4: DerFlotti ($65.69 in chips)
Seat 5: orbcrazyk ($53.37 in chips)
Seat 6: Soydemimami ($75.84 in chips)
Soydemimami: posts small blind $0.25
Lasch04: posts big blind $0.50
*** HOLE CARDS ***
Sack444: folds
olo0olo: folds
DerFlotti: raises $1 to $1.50
orbcrazyk: calls $1.50
Soydemimami: folds
Lasch04: folds
*** FLOP *** [9d 6h Kd]
DerFlotti: bets $1.50
orbcrazyk: raises $3.28 to $4.78
DerFlotti: calls $3.28
*** TURN *** [9d 6h Kd] [Qc]
DerFlotti: checks
orbcrazyk: bets $9.50
DerFlotti: folds
Uncalled bet ($9.50) returned to orbcrazyk
orbcrazyk collected $12.64 from pot
orbcrazyk: doesn't show hand
*** SUMMARY ***
Total pot $13.31 | Rake $0.67
Board [9d 6h Kd Qc]
Seat 1: Lasch04 (big blind) folded before Flop
Seat 2: Sack444 folded before Flop (didn't bet)
Seat 3: olo0olo folded before Flop (didn't bet)
Seat 4: DerFlotti folded on the Turn
Seat 5: orbcrazyk (button) collected ($12.64)
Seat 6: Soydemimami (small blind) folded before Flop


PokerStars Hand #208976409581:  Hold'em No Limit ($0.25/$0.50 USD) - 2020/02/08 11:36:11 ET
Table 'Acamar V' 6-max Seat #4 is the button
Seat 1: Lasch04 ($29.84 in chips)
Seat 2: Sack444 ($38.15 in chips)
Seat 3: olo0olo ($59.34 in chips)
Seat 4: DerFlotti ($60.95 in chips)
Seat 5: orbcrazyk ($53.62 in chips)
Seat 6: Soydemimami ($80.84 in chips)
orbcrazyk: posts small blind $0.25
Soydemimami: posts big blind $0.50
*** HOLE CARDS ***
Lasch04: folds
Sack444: folds
olo0olo: folds
DerFlotti: raises $1 to $1.50
orbcrazyk: folds
Soydemimami: raises $3.50 to $5
DerFlotti: calls $3.50
*** FLOP *** [Tc Js 2c]
Soydemimami: checks
DerFlotti: checks
*** TURN *** [Tc Js 2c] [Qh]
Soydemimami: checks
DerFlotti: checks
*** RIVER *** [Tc Js 2c Qh] [6s]
Soydemimami: checks
DerFlotti: checks
*** SHOW DOWN ***
Soydemimami: shows [9h 9d] (a pair of Nines)
DerFlotti: shows [Td Ac] (a pair of Tens)
DerFlotti collected $9.74 from pot
*** SUMMARY ***
Total pot $10.25 | Rake $0.51
Board [Tc Js 2c Qh 6s]
Seat 1: Lasch04 folded before Flop (didn't bet)
Seat 2: Sack444 folded before Flop (didn't bet)
Seat 3: olo0olo folded before Flop (didn't bet)
Seat 4: DerFlotti (button) showed [Td Ac] and won ($9.74) with a pair of Tens
Seat 5: orbcrazyk (small blind) folded before Flop
Seat 6: Soydemimami (big blind) showed [9h 9d] and lost with a pair of Nines


PokerStars Hand #208976444659:  Hold'em No Limit ($0.25/$0.50 USD) - 2020/02/08 11:37:16 ET
Table 'Acamar V' 6-max Seat #6 is the button
Seat 1: Lasch04 ($29.34 in chips)
Seat 2: Sack444 ($38.15 in chips)
Seat 3: olo0olo ($59.34 in chips)
Seat 4: DerFlotti ($59.41 in chips)
Seat 5: orbcrazyk ($59.73 in chips)
Seat 6: Soydemimami ($75.59 in chips)
Lasch04: posts small blind $0.25
Sack444: posts big blind $0.50
*** HOLE CARDS ***
olo0olo: raises $0.60 to $1.10
DerFlotti: folds
orbcrazyk: folds
Soydemimami: folds
Lasch04: folds
Sack444: raises $3.10 to $4.20
olo0olo: calls $3.10
*** FLOP *** [7d Jc 3h]
Sack444: checks
olo0olo: checks
*** TURN *** [7d Jc 3h] [2d]
Sack444: checks
olo0olo: checks
*** RIVER *** [7d Jc 3h 2d] [9s]
Sack444: checks
olo0olo: bets $3.50
Sack444: folds
Uncalled bet ($3.50) returned to olo0olo
olo0olo collected $8.22 from pot
olo0olo: doesn't show hand
*** SUMMARY ***
Total pot $8.65 | Rake $0.43
Board [7d Jc 3h 2d 9s]
Seat 1: Lasch04 (small blind) folded before Flop
Seat 2: Sack444 (big blind) folded on the River
Seat 3: olo0olo collected ($8.22)
Seat 4: DerFlotti folded before Flop (didn't bet)
Seat 5: orbcrazyk folded before Flop (didn't bet)
Seat 6: Soydemimami (button) folded before Flop (didn't bet)


PokerStars Hand #208976469236:  Hold'em No Limit ($0.25/$0.50 USD) - 2020/02/08 11:38:01 ET
Table 'Acamar V' 6-max Seat #1 is the button
Seat 1: Lasch04 ($29.09 in chips)
Seat 2: Sack444 ($33.95 in chips)
Seat 4: DerFlotti ($59.41 in chips)
Seat 5: orbcrazyk ($59.73 in chips)
Seat 6: Soydemimami ($75.59 in chips)
Sack444: posts small blind $0.25
olo0olo: is sitting out
DerFlotti: posts big blind $0.50
*** HOLE CARDS ***
olo0olo leaves the table
orbcrazyk: raises $1 to $1.50
Soydemimami: calls $1.50
Lasch04: folds
Sack444: folds
DerFlotti: folds
*** FLOP *** [2c 3c 9c]
markas1996 joins the table at seat #3
orbcrazyk: checks
Soydemimami: checks
*** TURN *** [2c 3c 9c] [Qd]
orbcrazyk: checks
Soydemimami: checks
*** RIVER *** [2c 3c 9c Qd] [Ts]
orbcrazyk: checks
Soydemimami: checks
*** SHOW DOWN ***
orbcrazyk: shows [Jd Ad] (high card Ace)
Soydemimami: shows [4c 4s] (a pair of Fours)
Soydemimami collected $3.56 from pot
*** SUMMARY ***
Total pot $3.75 | Rake $0.19
Board [2c 3c 9c Qd Ts]
Seat 1: Lasch04 (button) folded before Flop (didn't bet)
Seat 2: Sack444 (small blind) folded before Flop
Seat 4: DerFlotti (big blind) folded before Flop
Seat 5: orbcrazyk showed [Jd Ad] and lost with high card Ace
Seat 6: Soydemimami showed [4c 4s] and won ($3.56) with a pair of Fours


PokerStars Hand #208976487112:  Hold'em No Limit ($0.25/$0.50 USD) - 2020/02/08 11:38:34 ET
Table 'Acamar V' 6-max Seat #2 is the button
Seat 1: Lasch04 ($29.09 in chips)
Seat 2: Sack444 ($33.70 in chips)
Seat 4: DerFlotti ($58.91 in chips)
Seat 5: orbcrazyk ($58.23 in chips)
Seat 6: Soydemimami ($77.65 in chips)
DerFlotti: posts small blind $0.25
orbcrazyk: posts big blind $0.50
*** HOLE CARDS ***
Soydemimami: folds
Lasch04: folds
Sack444: raises $1 to $1.50
DerFlotti: folds
orbcrazyk: calls $1
*** FLOP *** [5h Qd 5s]
orbcrazyk: checks
Sack444: bets $2
orbcrazyk: folds
Uncalled bet ($2) returned to Sack444
Sack444 collected $3.09 from pot
Sack444: doesn't show hand
*** SUMMARY ***
Total pot $3.25 | Rake $0.16
Board [5h Qd 5s]
Seat 1: Lasch04 folded before Flop (didn't bet)
Seat 2: Sack444 (button) collected ($3.09)
Seat 4: DerFlotti (small blind) folded before Flop
Seat 5: orbcrazyk (big blind) folded on the Flop
Seat 6: Soydemimami folded before Flop (didn't bet)


PokerStars Hand #208976499396:  Hold'em No Limit ($0.25/$0.50 USD) - 2020/02/08 11:38:57 ET
Table 'Acamar V' 6-max Seat #4 is the button
Seat 1: Lasch04 ($29.09 in chips)
Seat 2: Sack444 ($35.29 in chips)
Seat 4: DerFlotti ($58.66 in chips)
Seat 5: orbcrazyk ($56.73 in chips)
Seat 6: Soydemimami ($77.65 in chips)
orbcrazyk: posts small blind $0.25
Soydemimami: posts big blind $0.50
markas1996: sits out
*** HOLE CARDS ***
Lasch04: folds
Sack444: folds
DerFlotti: raises $1 to $1.50
orbcrazyk: folds
Soydemimami: calls $1
*** FLOP *** [7s Qc 8c]
Soydemimami: checks
DerFlotti: checks
*** TURN *** [7s Qc 8c] [5h]
Soydemimami: checks
DerFlotti: checks
*** RIVER *** [7s Qc 8c 5h] [As]
Soydemimami: checks
DerFlotti: bets $1.55
Soydemimami: folds
Uncalled bet ($1.55) returned to DerFlotti
DerFlotti collected $3.09 from pot
DerFlotti: doesn't show hand
*** SUMMARY ***
Total pot $3.25 | Rake $0.16
Board [7s Qc 8c 5h As]
Seat 1: Lasch04 folded before Flop (didn't bet)
Seat 2: Sack444 folded before Flop (didn't bet)
Seat 4: DerFlotti (button) collected ($3.09)
Seat 5: orbcrazyk (small blind) folded before Flop
Seat 6: Soydemimami (big blind) folded on the River


PokerStars Hand #208976527614:  Hold'em No Limit ($0.25/$0.50 USD) - 2020/02/08 11:39:50 ET
Table 'Acamar V' 6-max Seat #6 is the button
Seat 1: Lasch04 ($28.59 in chips)
Seat 2: Sack444 ($35.29 in chips)
Seat 4: DerFlotti ($60.25 in chips)
Seat 5: orbcrazyk ($56.48 in chips)
Seat 6: Soydemimami ($76.65 in chips)
Lasch04: posts small blind $0.25
Sack444: posts big blind $0.50
markas1996: sits out
*** HOLE CARDS ***
DerFlotti: folds
orbcrazyk: raises $1 to $1.50
Soydemimami: folds
Lasch04: folds
Sack444: folds
Uncalled bet ($1) returned to orbcrazyk
orbcrazyk collected $1.25 from pot
orbcrazyk: doesn't show hand
*** SUMMARY ***
Total pot $1.25 | Rake $0
Seat 1: Lasch04 (small blind) folded before Flop
Seat 2: Sack444 (big blind) folded before Flop
Seat 4: DerFlotti folded before Flop (didn't bet)
Seat 5: orbcrazyk collected ($1.25)
Seat 6: Soydemimami (button) folded before Flop (didn't bet)


PokerStars Hand #208976518677:  Hold'em No Limit ($0.25/$0.50 USD) - 2020/02/08 11:39:33 ET
Table 'Acamar V' 6-max Seat #5 is the button
Seat 1: Lasch04 ($29.09 in chips)
Seat 2: Sack444 ($35.29 in chips)
Seat 4: DerFlotti ($60.25 in chips)
Seat 5: orbcrazyk ($56.48 in chips)
Seat 6: Soydemimami ($76.15 in chips)
Soydemimami: posts small blind $0.25
Lasch04: posts big blind $0.50
markas1996: sits out
*** HOLE CARDS ***
Sack444: folds
DerFlotti: folds
orbcrazyk: folds
Soydemimami: raises $1 to $1.50
Lasch04: folds
Uncalled bet ($1) returned to Soydemimami
Soydemimami collected $1 from pot
*** SUMMARY ***
Total pot $1 | Rake $0
Seat 1: Lasch04 (big blind) folded before Flop
Seat 2: Sack444 folded before Flop (didn't bet)
Seat 4: DerFlotti folded before Flop (didn't bet)
Seat 5: orbcrazyk (button) folded before Flop (didn't bet)
Seat 6: Soydemimami (small blind) collected ($1)


PokerStars Hand #208976568412:  Hold'em No Limit ($0.25/$0.50 USD) - 2020/02/08 11:41:03 ET
Table 'Acamar V' 6-max Seat #2 is the button
Seat 1: Lasch04 ($28.34 in chips)
Seat 2: Sack444 ($34.54 in chips)
Seat 3: markas1996 ($50 in chips)
Seat 4: DerFlotti ($60.25 in chips)
Seat 5: orbcrazyk ($57.23 in chips)
Seat 6: Soydemimami ($124.90 in chips)
markas1996: posts small blind $0.25
DerFlotti: posts big blind $0.50
*** HOLE CARDS ***
orbcrazyk: folds
Soydemimami: folds
Lasch04: raises $1 to $1.50
Sack444: folds
markas1996: folds
DerFlotti: folds
Uncalled bet ($1) returned to Lasch04
Lasch04 collected $1.25 from pot
Lasch04: doesn't show hand
*** SUMMARY ***
Total pot $1.25 | Rake $0
Seat 1: Lasch04 collected ($1.25)
Seat 2: Sack444 (button) folded before Flop (didn't bet)
Seat 3: markas1996 (small blind) folded before Flop
Seat 4: DerFlotti (big blind) folded before Flop
Seat 5: orbcrazyk folded before Flop (didn't bet)
Seat 6: Soydemimami folded before Flop (didn't bet)


PokerStars Hand #208976534678:  Hold'em No Limit ($0.25/$0.50 USD) - 2020/02/08 11:40:02 ET
Table 'Acamar V' 6-max Seat #1 is the button
Seat 1: Lasch04 ($28.34 in chips)
Seat 2: Sack444 ($34.79 in chips)
Seat 3: markas1996 ($50 in chips)
Seat 4: DerFlotti ($60.25 in chips)
Seat 5: orbcrazyk ($57.23 in chips)
Seat 6: Soydemimami ($76.65 in chips)
Sack444: posts small blind $0.25
markas1996: posts big blind $0.50
*** HOLE CARDS ***
DerFlotti: folds
orbcrazyk: folds
Soydemimami: raises $0.75 to $1.25
Lasch04: folds
Sack444: folds
markas1996: raises $3.75 to $5
Soydemimami: raises $7 to $12
markas1996: raises $38 to $50 and is all-in
Soydemimami: calls $38
*** FLOP *** [3s Th 3h]
*** TURN *** [3s Th 3h] [Qs]
*** RIVER *** [3s Th 3h Qs] [Ts]
*** SHOW DOWN ***
markas1996: shows [Kc Kd] (two pair, Kings and Tens)
Soydemimami: shows [As Ac] (two pair, Aces and Tens)
Soydemimami collected $98.25 from pot
*** SUMMARY ***
Total pot $100.25 | Rake $2
Board [3s Th 3h Qs Ts]
Seat 1: Lasch04 (button) folded before Flop (didn't bet)
Seat 2: Sack444 (small blind) folded before Flop
Seat 3: markas1996 (big blind) showed [Kc Kd] and lost with two pair, Kings and Tens
Seat 4: DerFlotti folded before Flop (didn't bet)
Seat 5: orbcrazyk folded before Flop (didn't bet)
Seat 6: Soydemimami showed [As Ac] and won ($98.25) with two pair, Aces and Tens


PokerStars Hand #208976590392:  Hold'em No Limit ($0.25/$0.50 USD) - 2020/02/08 11:41:43 ET
Table 'Acamar V' 6-max Seat #4 is the button
Seat 1: Lasch04 ($28.84 in chips)
Seat 2: Sack444 ($34.54 in chips)
Seat 3: markas1996 ($50 in chips)
Seat 4: DerFlotti ($59.50 in chips)
Seat 5: orbcrazyk ($56.98 in chips)
Seat 6: Soydemimami ($123.65 in chips)
orbcrazyk: posts small blind $0.25
Soydemimami: posts big blind $0.50
*** HOLE CARDS ***
Lasch04: folds
Sack444: folds
markas1996: raises $0.75 to $1.25
DerFlotti: folds
orbcrazyk: raises $3.75 to $5
Soydemimami: folds
markas1996: calls $3.75
*** FLOP *** [Qd 2d 4s]
orbcrazyk: checks
markas1996: checks
*** TURN *** [Qd 2d 4s] [7s]
orbcrazyk: bets $6
markas1996: folds
Uncalled bet ($6) returned to orbcrazyk
orbcrazyk collected $9.98 from pot
orbcrazyk: doesn't show hand
*** SUMMARY ***
Total pot $10.50 | Rake $0.52
Board [Qd 2d 4s 7s]
Seat 1: Lasch04 folded before Flop (didn't bet)
Seat 2: Sack444 folded before Flop (didn't bet)
Seat 3: markas1996 folded on the Turn
Seat 4: DerFlotti (button) folded before Flop (didn't bet)
Seat 5: orbcrazyk (small blind) collected ($9.98)
Seat 6: Soydemimami (big blind) folded before Flop


PokerStars Hand #208976574130:  Hold'em No Limit ($0.25/$0.50 USD) - 2020/02/08 11:41:13 ET
Table 'Acamar V' 6-max Seat #3 is the button
Seat 1: Lasch04 ($29.09 in chips)
Seat 2: Sack444 ($34.54 in chips)
Seat 3: markas1996 ($50 in chips)
Seat 4: DerFlotti ($59.75 in chips)
Seat 5: orbcrazyk ($57.23 in chips)
Seat 6: Soydemimami ($124.90 in chips)
DerFlotti: posts small blind $0.25
orbcrazyk: posts big blind $0.50
*** HOLE CARDS ***
Soydemimami: raises $0.75 to $1.25
Lasch04: raises $3.75 to $5
Sack444: folds
markas1996: folds
DerFlotti: folds
orbcrazyk: raises $6.50 to $11.50
Soydemimami: folds
Lasch04: raises $17.59 to $29.09 and is all-in
orbcrazyk: calls $17.59
*** FLOP *** [2s 8d Kh]
*** TURN *** [2s 8d Kh] [3h]
*** RIVER *** [2s 8d Kh 3h] [As]
*** SHOW DOWN ***
orbcrazyk: shows [Ac Kc] (two pair, Aces and Kings)
Lasch04: shows [Ad Ks] (two pair, Aces and Kings)
orbcrazyk collected $28.84 from pot
Lasch04 collected $28.84 from pot
*** SUMMARY ***
Total pot $59.68 | Rake $2
Board [2s 8d Kh 3h As]
Seat 1: Lasch04 showed [Ad Ks] and won ($28.84) with two pair, Aces and Kings
Seat 2: Sack444 folded before Flop (didn't bet)
Seat 3: markas1996 (button) folded before Flop (didn't bet)
Seat 4: DerFlotti (small blind) folded before Flop
Seat 5: orbcrazyk (big blind) showed [Ac Kc] and won ($28.84) with two pair, Aces and Kings
Seat 6: Soydemimami folded before Flop


PokerStars Hand #208976644594:  Hold'em No Limit ($0.25/$0.50 USD) - 2020/02/08 11:43:06 ET
Table 'Acamar V' 6-max Seat #6 is the button
Seat 1: Lasch04 ($29.74 in chips)
Seat 2: Sack444 ($50 in chips)
Seat 3: markas1996 ($50 in chips)
Seat 4: DerFlotti ($59.50 in chips)
Seat 5: orbcrazyk ($61.96 in chips)
Seat 6: Soydemimami ($122.15 in chips)
Lasch04: posts small blind $0.25
Sack444: posts big blind $0.50
*** HOLE CARDS ***
markas1996: folds
DerFlotti: folds
orbcrazyk: folds
Soydemimami: folds
Lasch04: folds
Uncalled bet ($0.25) returned to Sack444
Sack444 collected $0.50 from pot
Sack444: doesn't show hand
*** SUMMARY ***
Total pot $0.50 | Rake $0
Seat 1: Lasch04 (small blind) folded before Flop
Seat 2: Sack444 (big blind) collected ($0.50)
Seat 3: markas1996 folded before Flop (didn't bet)
Seat 4: DerFlotti folded before Flop (didn't bet)
Seat 5: orbcrazyk folded before Flop (didn't bet)
Seat 6: Soydemimami (button) folded before Flop (didn't bet)


PokerStars Hand #208976618999:  Hold'em No Limit ($0.25/$0.50 USD) - 2020/02/08 11:42:36 ET
Table 'Acamar V' 6-max Seat #5 is the button
Seat 1: Lasch04 ($28.84 in chips)
Seat 2: Sack444 ($50 in chips)
Seat 3: markas1996 ($50 in chips)
Seat 4: DerFlotti ($59.50 in chips)
Seat 5: orbcrazyk ($61.96 in chips)
Seat 6: Soydemimami ($123.15 in chips)
Soydemimami: posts small blind $0.25
Lasch04: posts big blind $0.50
*** HOLE CARDS ***
Sack444: folds
markas1996: folds
DerFlotti: folds
orbcrazyk: folds
Soydemimami: calls $0.25
Lasch04: checks
*** FLOP *** [Tc 4h 3d]
Soydemimami: bets $0.50
Lasch04: calls $0.50
*** TURN *** [Tc 4h 3d] [4s]
Soydemimami: checks
Lasch04: bets $0.95
Soydemimami: folds
Uncalled bet ($0.95) returned to Lasch04
Lasch04 collected $1.90 from pot
Lasch04: doesn't show hand
*** SUMMARY ***
Total pot $2 | Rake $0.10
Board [Tc 4h 3d 4s]
Seat 1: Lasch04 (big blind) collected ($1.90)
Seat 2: Sack444 folded before Flop (didn't bet)
Seat 3: markas1996 folded before Flop (didn't bet)
Seat 4: DerFlotti folded before Flop (didn't bet)
Seat 5: orbcrazyk (button) folded before Flop (didn't bet)
Seat 6: Soydemimami (small blind) folded on the Turn


PokerStars Hand #208976650934:  Hold'em No Limit ($0.25/$0.50 USD) - 2020/02/08 11:43:18 ET
Table 'Acamar V' 6-max Seat #1 is the button
Seat 1: Lasch04 ($29.49 in chips)
Seat 2: Sack444 ($50.25 in chips)
Seat 3: markas1996 ($50 in chips)
Seat 4: DerFlotti ($59.50 in chips)
Seat 5: orbcrazyk ($61.96 in chips)
Seat 6: Soydemimami ($122.15 in chips)
Sack444: posts small blind $0.25
markas1996: posts big blind $0.50
*** HOLE CARDS ***
DerFlotti: folds
orbcrazyk: folds
Soydemimami: folds
Lasch04: raises $1 to $1.50
Sack444: folds
markas1996: folds
Uncalled bet ($1) returned to Lasch04
Lasch04 collected $1.25 from pot
Lasch04: doesn't show hand
*** SUMMARY ***
Total pot $1.25 | Rake $0
Seat 1: Lasch04 (button) collected ($1.25)
Seat 2: Sack444 (small blind) folded before Flop
Seat 3: markas1996 (big blind) folded before Flop
Seat 4: DerFlotti folded before Flop (didn't bet)
Seat 5: orbcrazyk folded before Flop (didn't bet)
Seat 6: Soydemimami folded before Flop (didn't bet)


PokerStars Hand #208976658679:  Hold'em No Limit ($0.25/$0.50 USD) - 2020/02/08 11:43:33 ET
Table 'Acamar V' 6-max Seat #2 is the button
Seat 1: Lasch04 ($30.24 in chips)
Seat 2: Sack444 ($50 in chips)
Seat 3: markas1996 ($50 in chips)
Seat 4: DerFlotti ($59.50 in chips)
Seat 5: orbcrazyk ($61.96 in chips)
Seat 6: Soydemimami ($122.15 in chips)
markas1996: posts small blind $0.25
DerFlotti: posts big blind $0.50
*** HOLE CARDS ***
orbcrazyk: folds
Soydemimami: folds
orbcrazyk leaves the table
Lasch04: calls $0.50
Sack444: folds
markas1996: calls $0.25
Losttt joins the table at seat #5
DerFlotti: checks
*** FLOP *** [8s 8d Ks]
markas1996: checks
DerFlotti: checks
Lasch04: bets $1.50
markas1996: folds
DerFlotti: folds
Uncalled bet ($1.50) returned to Lasch04
Losttt leaves the table
Lasch04 collected $1.42 from pot
Lasch04: doesn't show hand
*** SUMMARY ***
Total pot $1.50 | Rake $0.08
Board [8s 8d Ks]
Seat 1: Lasch04 collected ($1.42)
Seat 2: Sack444 (button) folded before Flop (didn't bet)
Seat 3: markas1996 (small blind) folded on the Flop
Seat 4: DerFlotti (big blind) folded on the Flop
Seat 5: orbcrazyk folded before Flop (didn't bet)
Seat 6: Soydemimami folded before Flop (didn't bet)


PokerStars Hand #208976677084:  Hold'em No Limit ($0.25/$0.50 USD) - 2020/02/08 11:44:07 ET
Table 'Acamar V' 6-max Seat #3 is the button
Seat 1: Lasch04 ($31.16 in chips)
Seat 2: Sack444 ($50 in chips)
Seat 3: markas1996 ($50 in chips)
Seat 4: DerFlotti ($59 in chips)
Seat 6: Soydemimami ($122.15 in chips)
sw_iceman joins the table at seat #5
DerFlotti: posts small blind $0.25
Soydemimami: posts big blind $0.50
*** HOLE CARDS ***
Lasch04: folds
Sack444: raises $1 to $1.50
markas1996: raises $3 to $4.50
DerFlotti: folds
Soydemimami: folds
Sack444: calls $3
*** FLOP *** [9d 9s Ah]
Sack444: checks
markas1996: bets $2.32
Sack444: calls $2.32
*** TURN *** [9d 9s Ah] [6s]
Sack444: checks
markas1996: checks
*** RIVER *** [9d 9s Ah 6s] [9h]
Sack444: bets $3.50
markas1996: raises $10.25 to $13.75
Sack444: calls $10.25
*** SHOW DOWN ***
markas1996: shows [Ac 3c] (a full house, Nines full of Aces)
Sack444: shows [Ad 6d] (a full house, Nines full of Aces)
Sack444 collected $19.95 from pot
markas1996 collected $19.94 from pot
*** SUMMARY ***
Total pot $41.89 | Rake $2
Board [9d 9s Ah 6s 9h]
Seat 1: Lasch04 folded before Flop (didn't bet)
Seat 2: Sack444 showed [Ad 6d] and won ($19.95) with a full house, Nines full of Aces
Seat 3: markas1996 (button) showed [Ac 3c] and won ($19.94) with a full house, Nines full of Aces
Seat 4: DerFlotti (small blind) folded before Flop
Seat 6: Soydemimami (big blind) folded before Flop


PokerStars Hand #208976707073:  Hold'em No Limit ($0.25/$0.50 USD) - 2020/02/08 11:45:03 ET
Table 'Acamar V' 6-max Seat #4 is the button
Seat 1: Lasch04 ($31.16 in chips)
Seat 2: Sack444 ($49.38 in chips)
Seat 3: markas1996 ($50 in chips)
Seat 4: DerFlotti ($58.75 in chips)
Seat 6: Soydemimami ($121.65 in chips)
Soydemimami: posts small blind $0.25
Lasch04: posts big blind $0.50
*** HOLE CARDS ***
Sack444: raises $1 to $1.50
markas1996: folds
DerFlotti: folds
Soydemimami: folds
Lasch04: calls $1
*** FLOP *** [2h Qc Ah]
Lasch04: checks
Sack444: bets $2
Lasch04: calls $2
*** TURN *** [2h Qc Ah] [Jd]
Lasch04: checks
Sack444: checks
*** RIVER *** [2h Qc Ah Jd] [4c]
Lasch04: bets $3.45
Sack444: calls $3.45
*** SHOW DOWN ***
Lasch04: shows [Th Jh] (a pair of Jacks)
Sack444: shows [Qh 7h] (a pair of Queens)
Sack444 collected $13.44 from pot
*** SUMMARY ***
Total pot $14.15 | Rake $0.71
Board [2h Qc Ah Jd 4c]
Seat 1: Lasch04 (big blind) showed [Th Jh] and lost with a pair of Jacks
Seat 2: Sack444 showed [Qh 7h] and won ($13.44) with a pair of Queens
Seat 3: markas1996 folded before Flop (didn't bet)
Seat 4: DerFlotti (button) folded before Flop (didn't bet)
Seat 6: Soydemimami (small blind) folded before Flop


PokerStars Hand #208976724330:  Hold'em No Limit ($0.25/$0.50 USD) - 2020/02/08 11:45:34 ET
Table 'Acamar V' 6-max Seat #6 is the button
Seat 1: Lasch04 ($24.21 in chips)
Seat 2: Sack444 ($55.87 in chips)
Seat 3: markas1996 ($50 in chips)
Seat 4: DerFlotti ($58.75 in chips)
Seat 6: Soydemimami ($121.40 in chips)
Lasch04: posts small blind $0.25
Sack444: posts big blind $0.50
sw_iceman: sits out
*** HOLE CARDS ***
markas1996: folds
DerFlotti has timed out
DerFlotti: folds
Soydemimami: raises $0.50 to $1
Lasch04: folds
Sack444: calls $0.50
*** FLOP *** [Kd 8s 4d]
Sack444: checks
Soydemimami: bets $0.54
Sack444: calls $0.54
*** TURN *** [Kd 8s 4d] [8c]
Sack444: checks
Soydemimami: bets $2.50
Sack444: folds
Uncalled bet ($2.50) returned to Soydemimami
Soydemimami collected $3.16 from pot
*** SUMMARY ***
Total pot $3.33 | Rake $0.17
Board [Kd 8s 4d 8c]
Seat 1: Lasch04 (small blind) folded before Flop
Seat 2: Sack444 (big blind) folded on the Turn
Seat 3: markas1996 folded before Flop (didn't bet)
Seat 4: DerFlotti folded before Flop (didn't bet)
Seat 6: Soydemimami (button) collected ($3.16)


PokerStars Hand #208976746237:  Hold'em No Limit ($0.25/$0.50 USD) - 2020/02/08 11:46:15 ET
Table 'Acamar V' 6-max Seat #1 is the button
Seat 1: Lasch04 ($23.96 in chips)
Seat 2: Sack444 ($54.33 in chips)
Seat 3: markas1996 ($50 in chips)
Seat 4: DerFlotti ($58.75 in chips)
Seat 6: Soydemimami ($123.02 in chips)
Sack444: posts small blind $0.25
markas1996: posts big blind $0.50
sw_iceman: sits out
*** HOLE CARDS ***
DerFlotti: folds
Soydemimami: raises $0.75 to $1.25
Lasch04: folds
Sack444: folds
markas1996: calls $0.75
*** FLOP *** [As 5h 9d]
markas1996: checks
Soydemimami: bets $0.86
markas1996: calls $0.86
*** TURN *** [As 5h 9d] [Qs]
markas1996: checks
Soydemimami: bets $6
markas1996: folds
Uncalled bet ($6) returned to Soydemimami
Soydemimami collected $4.25 from pot
Soydemimami: doesn't show hand
*** SUMMARY ***
Total pot $4.47 | Rake $0.22
Board [As 5h 9d Qs]
Seat 1: Lasch04 (button) folded before Flop (didn't bet)
Seat 2: Sack444 (small blind) folded before Flop
Seat 3: markas1996 (big blind) folded on the Turn
Seat 4: DerFlotti folded before Flop (didn't bet)
Seat 6: Soydemimami collected ($4.25)


PokerStars Hand #208976767681:  Hold'em No Limit ($0.25/$0.50 USD) - 2020/02/08 11:46:55 ET
Table 'Acamar V' 6-max Seat #2 is the button
Seat 1: Lasch04 ($23.96 in chips)
Seat 2: Sack444 ($54.08 in chips)
Seat 3: markas1996 ($50 in chips)
Seat 4: DerFlotti ($58.75 in chips)
Seat 6: Soydemimami ($125.16 in chips)
markas1996: posts small blind $0.25
DerFlotti: posts big blind $0.50
sw_iceman: sits out
*** HOLE CARDS ***
Soydemimami: folds
Lasch04: calls $0.50
Sack444: raises $1.50 to $2
markas1996: folds
DerFlotti: folds
Lasch04: calls $1.50
*** FLOP *** [Jh 5s As]
Lasch04: checks
Sack444: bets $3
Lasch04: calls $3
*** TURN *** [Jh 5s As] [8s]
Lasch04: checks
Sack444: checks
*** RIVER *** [Jh 5s As 8s] [9c]
Lasch04: checks
Sack444: checks
*** SHOW DOWN ***
Lasch04: shows [3s 3c] (a pair of Threes)
Sack444: mucks hand
Lasch04 collected $10.21 from pot
*** SUMMARY ***
Total pot $10.75 | Rake $0.54
Board [Jh 5s As 8s 9c]
Seat 1: Lasch04 showed [3s 3c] and won ($10.21) with a pair of Threes
Seat 2: Sack444 (button) mucked
Seat 3: markas1996 (small blind) folded before Flop
Seat 4: DerFlotti (big blind) folded before Flop
Seat 6: Soydemimami folded before Flop (didn't bet)


PokerStars Hand #208976783725:  Hold'em No Limit ($0.25/$0.50 USD) - 2020/02/08 11:47:26 ET
Table 'Acamar V' 6-max Seat #3 is the button
Seat 1: Lasch04 ($29.17 in chips)
Seat 2: Sack444 ($49.08 in chips)
Seat 3: markas1996 ($50 in chips)
Seat 4: DerFlotti ($58.25 in chips)
Seat 5: sw_iceman ($50 in chips)
Seat 6: Soydemimami ($125.16 in chips)
DerFlotti: posts small blind $0.25
sw_iceman: posts big blind $0.50
*** HOLE CARDS ***
Soydemimami: folds
Lasch04: raises $1 to $1.50
Sack444: folds
markas1996: folds
DerFlotti: folds
sw_iceman: folds
Uncalled bet ($1) returned to Lasch04
Lasch04 collected $1.25 from pot
Lasch04: doesn't show hand
*** SUMMARY ***
Total pot $1.25 | Rake $0
Seat 1: Lasch04 collected ($1.25)
Seat 2: Sack444 folded before Flop (didn't bet)
Seat 3: markas1996 (button) folded before Flop (didn't bet)
Seat 4: DerFlotti (small blind) folded before Flop
Seat 5: sw_iceman (big blind) folded before Flop
Seat 6: Soydemimami folded before Flop (didn't bet)


PokerStars Hand #208976794703:  Hold'em No Limit ($0.25/$0.50 USD) - 2020/02/08 11:47:46 ET
Table 'Acamar V' 6-max Seat #4 is the button
Seat 1: Lasch04 ($29.92 in chips)
Seat 2: Sack444 ($49.08 in chips)
Seat 3: markas1996 ($50 in chips)
Seat 4: DerFlotti ($58 in chips)
Seat 5: sw_iceman ($50 in chips)
Seat 6: Soydemimami ($125.16 in chips)
sw_iceman: posts small blind $0.25
Soydemimami: posts big blind $0.50
*** HOLE CARDS ***
Lasch04: raises $1 to $1.50
Sack444: folds
markas1996: folds
DerFlotti: calls $1.50
sw_iceman: folds
Soydemimami: folds
*** FLOP *** [Jd 8d 5s]
Lasch04: bets $2.50
DerFlotti: folds
Uncalled bet ($2.50) returned to Lasch04
Lasch04 collected $3.56 from pot
Lasch04: doesn't show hand
*** SUMMARY ***
Total pot $3.75 | Rake $0.19
Board [Jd 8d 5s]
Seat 1: Lasch04 collected ($3.56)
Seat 2: Sack444 folded before Flop (didn't bet)
Seat 3: markas1996 folded before Flop (didn't bet)
Seat 4: DerFlotti (button) folded on the Flop
Seat 5: sw_iceman (small blind) folded before Flop
Seat 6: Soydemimami (big blind) folded before Flop


PokerStars Hand #208976832679:  Hold'em No Limit ($0.25/$0.50 USD) - 2020/02/08 11:48:57 ET
Table 'Acamar V' 6-max Seat #2 is the button
Seat 1: Lasch04 ($29.83 in chips)
Seat 2: Sack444 ($48.33 in chips)
Seat 3: markas1996 ($51.45 in chips)
Seat 4: DerFlotti ($57.25 in chips)
Seat 5: sw_iceman ($50.75 in chips)
Seat 6: Soydemimami ($124.41 in chips)
markas1996: posts small blind $0.25
DerFlotti: posts big blind $0.50
*** HOLE CARDS ***
sw_iceman: folds
Soydemimami: raises $0.75 to $1.25
Lasch04: folds
Sack444: folds
markas1996: folds
DerFlotti: calls $0.75
*** FLOP *** [3h Td Th]
DerFlotti: checks
Soydemimami: bets $1.31
DerFlotti: folds
Uncalled bet ($1.31) returned to Soydemimami
Soydemimami collected $2.61 from pot
Soydemimami: doesn't show hand
*** SUMMARY ***
Total pot $2.75 | Rake $0.14
Board [3h Td Th]
Seat 1: Lasch04 folded before Flop (didn't bet)
Seat 2: Sack444 (button) folded before Flop (didn't bet)
Seat 3: markas1996 (small blind) folded before Flop
Seat 4: DerFlotti (big blind) folded on the Flop
Seat 5: sw_iceman folded before Flop (didn't bet)
Seat 6: Soydemimami collected ($2.61)


PokerStars Hand #208976805099:  Hold'em No Limit ($0.25/$0.50 USD) - 2020/02/08 11:48:05 ET
Table 'Acamar V' 6-max Seat #5 is the button
Seat 1: Lasch04 ($31.98 in chips)
Seat 2: Sack444 ($49.08 in chips)
Seat 3: markas1996 ($50 in chips)
Seat 4: DerFlotti ($56.50 in chips)
Seat 5: sw_iceman ($50 in chips)
Seat 6: Soydemimami ($124.66 in chips)
Soydemimami: posts small blind $0.25
Lasch04: posts big blind $0.50
*** HOLE CARDS ***
Sack444: folds
markas1996: raises $0.75 to $1.25
DerFlotti: folds
sw_iceman: folds
Soydemimami: folds
Lasch04: calls $0.75
*** FLOP *** [7h 4h Kd]
Lasch04: checks
markas1996: bets $0.65
Lasch04: calls $0.65
*** TURN *** [7h 4h Kd] [Jd]
Lasch04: checks
markas1996: bets $4.75
Lasch04: folds
Uncalled bet ($4.75) returned to markas1996
markas1996 collected $3.85 from pot
*** SUMMARY ***
Total pot $4.05 | Rake $0.20
Board [7h 4h Kd Jd]
Seat 1: Lasch04 (big blind) folded on the Turn
Seat 2: Sack444 folded before Flop (didn't bet)
Seat 3: markas1996 collected ($3.85)
Seat 4: DerFlotti folded before Flop (didn't bet)
Seat 5: sw_iceman (button) folded before Flop (didn't bet)
Seat 6: Soydemimami (small blind) folded before Flop


PokerStars Hand #208976827114:  Hold'em No Limit ($0.25/$0.50 USD) - 2020/02/08 11:48:47 ET
Table 'Acamar V' 6-max Seat #1 is the button
Seat 1: Lasch04 ($29.83 in chips)
Seat 2: Sack444 ($48.58 in chips)
Seat 3: markas1996 ($51.95 in chips)
Seat 4: DerFlotti ($57.25 in chips)
Seat 5: sw_iceman ($50 in chips)
Seat 6: Soydemimami ($124.41 in chips)
Sack444: posts small blind $0.25
markas1996: posts big blind $0.50
*** HOLE CARDS ***
DerFlotti: folds
sw_iceman: raises $1 to $1.50
Soydemimami: folds
Lasch04: folds
Sack444: folds
markas1996: folds
Uncalled bet ($1) returned to sw_iceman
sw_iceman collected $1.25 from pot
sw_iceman: doesn't show hand
*** SUMMARY ***
Total pot $1.25 | Rake $0
Seat 1: Lasch04 (button) folded before Flop (didn't bet)
Seat 2: Sack444 (small blind) folded before Flop
Seat 3: markas1996 (big blind) folded before Flop
Seat 4: DerFlotti folded before Flop (didn't bet)
Seat 5: sw_iceman collected ($1.25)
Seat 6: Soydemimami folded before Flop (didn't bet)


PokerStars Hand #208976820702:  Hold'em No Limit ($0.25/$0.50 USD) - 2020/02/08 11:48:35 ET
Table 'Acamar V' 6-max Seat #6 is the button
Seat 1: Lasch04 ($30.08 in chips)
Seat 2: Sack444 ($49.08 in chips)
Seat 3: markas1996 ($51.95 in chips)
Seat 4: DerFlotti ($56.50 in chips)
Seat 5: sw_iceman ($50 in chips)
Seat 6: Soydemimami ($124.41 in chips)
Lasch04: posts small blind $0.25
Sack444: posts big blind $0.50
*** HOLE CARDS ***
markas1996: folds
DerFlotti: raises $1 to $1.50
sw_iceman: folds
Soydemimami: folds
Lasch04: folds
Sack444: folds
Uncalled bet ($1) returned to DerFlotti
DerFlotti collected $1.25 from pot
DerFlotti: doesn't show hand
*** SUMMARY ***
Total pot $1.25 | Rake $0
Seat 1: Lasch04 (small blind) folded before Flop
Seat 2: Sack444 (big blind) folded before Flop
Seat 3: markas1996 folded before Flop (didn't bet)
Seat 4: DerFlotti collected ($1.25)
Seat 5: sw_iceman folded before Flop (didn't bet)
Seat 6: Soydemimami (button) folded before Flop (didn't bet)


PokerStars Hand #208976862578:  Hold'em No Limit ($0.25/$0.50 USD) - 2020/02/08 11:49:52 ET
Table 'Acamar V' 6-max Seat #4 is the button
Seat 2: Sack444 ($76.91 in chips)
Seat 3: markas1996 ($51.20 in chips)
Seat 4: DerFlotti ($55.75 in chips)
Seat 5: sw_iceman ($50.25 in chips)
Seat 6: Soydemimami ($125.77 in chips)
sw_iceman: posts small blind $0.25
Soydemimami: posts big blind $0.50
*** HOLE CARDS ***
Sack444: folds
markas1996: folds
DerFlotti: calls $0.50
Lasch04 leaves the table
sw_iceman: folds
Soydemimami: checks
*** FLOP *** [7h Ah 8d]
Soydemimami: checks
DerFlotti: checks
*** TURN *** [7h Ah 8d] [5c]
Sack444 leaves the table
Soydemimami: bets $1
DerFlotti: calls $1
*** RIVER *** [7h Ah 8d 5c] [Jh]
Soydemimami: bets $2
DerFlotti: calls $2
*** SHOW DOWN ***
Soydemimami: shows [2s 9s] (high card Ace)
DerFlotti: shows [Jc 7c] (two pair, Jacks and Sevens)
DerFlotti collected $6.89 from pot
*** SUMMARY ***
Total pot $7.25 | Rake $0.36
Board [7h Ah 8d 5c Jh]
Seat 2: Sack444 folded before Flop (didn't bet)
Seat 3: markas1996 folded before Flop (didn't bet)
Seat 4: DerFlotti (button) showed [Jc 7c] and won ($6.89) with two pair, Jacks and Sevens
Seat 5: sw_iceman (small blind) folded before Flop
Seat 6: Soydemimami (big blind) showed [2s 9s] and lost with high card Ace


PokerStars Hand #208976842372:  Hold'em No Limit ($0.25/$0.50 USD) - 2020/02/08 11:49:15 ET
Table 'Acamar V' 6-max Seat #3 is the button
Seat 1: Lasch04 ($29.83 in chips)
Seat 2: Sack444 ($48.33 in chips)
Seat 3: markas1996 ($51.20 in chips)
Seat 4: DerFlotti ($56 in chips)
Seat 5: sw_iceman ($50.75 in chips)
Seat 6: Soydemimami ($125.77 in chips)
DerFlotti: posts small blind $0.25
sw_iceman: posts big blind $0.50
*** HOLE CARDS ***
Soydemimami: folds
Lasch04: raises $1 to $1.50
Sack444: raises $3 to $4.50
markas1996: folds
DerFlotti: folds
sw_iceman: folds
Lasch04: calls $3
*** FLOP *** [Ks 9s 5s]
Lasch04: checks
Sack444: checks
*** TURN *** [Ks 9s 5s] [5c]
Lasch04: checks
Sack444: checks
*** RIVER *** [Ks 9s 5s 5c] [Jh]
Lasch04: checks
Sack444: bets $3.50
Lasch04: raises $21.83 to $25.33 and is all-in
Sack444: calls $21.83
*** SHOW DOWN ***
Lasch04: shows [Ad Ts] (a pair of Fives)
Sack444: shows [Ah Js] (two pair, Jacks and Fives)
Sack444 collected $58.41 from pot
*** SUMMARY ***
Total pot $60.41 | Rake $2
Board [Ks 9s 5s 5c Jh]
Seat 1: Lasch04 showed [Ad Ts] and lost with a pair of Fives
Seat 2: Sack444 showed [Ah Js] and won ($58.41) with two pair, Jacks and Fives
Seat 3: markas1996 (button) folded before Flop (didn't bet)
Seat 4: DerFlotti (small blind) folded before Flop
Seat 5: sw_iceman (big blind) folded before Flop
Seat 6: Soydemimami folded before Flop (didn't bet)


PokerStars Hand #208976910165:  Hold'em No Limit ($0.25/$0.50 USD) - 2020/02/08 11:51:20 ET
Table 'Acamar V' 6-max Seat #6 is the button
Seat 3: markas1996 ($50 in chips)
Seat 4: DerFlotti ($58.14 in chips)
Seat 5: sw_iceman ($50 in chips)
Seat 6: Soydemimami ($173.72 in chips)
markas1996: posts small blind $0.25
DerFlotti: posts big blind $0.50
*** HOLE CARDS ***
sw_iceman: folds
Soydemimami: raises $0.50 to $1
markas1996: folds
DerFlotti: folds
Uncalled bet ($0.50) returned to Soydemimami
Soydemimami collected $1.25 from pot
*** SUMMARY ***
Total pot $1.25 | Rake $0
Seat 3: markas1996 (small blind) folded before Flop
Seat 4: DerFlotti (big blind) folded before Flop
Seat 5: sw_iceman folded before Flop (didn't bet)
Seat 6: Soydemimami (button) collected ($1.25)


PokerStars Hand #208976876235:  Hold'em No Limit ($0.25/$0.50 USD) - 2020/02/08 11:50:18 ET
Table 'Acamar V' 6-max Seat #5 is the button
Seat 3: markas1996 ($51.20 in chips)
Seat 4: DerFlotti ($59.14 in chips)
Seat 5: sw_iceman ($50 in chips)
Seat 6: Soydemimami ($122.27 in chips)
Soydemimami: posts small blind $0.25
markas1996: posts big blind $0.50
*** HOLE CARDS ***
DerFlotti: raises $0.50 to $1
sw_iceman: folds
Soydemimami: raises $3.50 to $4.50
markas1996: raises $7 to $11.50
DerFlotti: folds
Soydemimami: calls $7
*** FLOP *** [5s 9s Jd]
Soydemimami: checks
markas1996: bets $6.50
Soydemimami: raises $48.94 to $55.44
markas1996: calls $33.20 and is all-in
Uncalled bet ($15.74) returned to Soydemimami
*** TURN *** [5s 9s Jd] [8s]
*** RIVER *** [5s 9s Jd 8s] [4h]
*** SHOW DOWN ***
Soydemimami: shows [Ad Ac] (a pair of Aces)
markas1996: shows [Qc Qh] (a pair of Queens)
Soydemimami collected $102.65 from pot
*** SUMMARY ***
Total pot $103.40 | Rake $0.75
Board [5s 9s Jd 8s 4h]
Seat 3: markas1996 (big blind) showed [Qc Qh] and lost with a pair of Queens
Seat 4: DerFlotti folded before Flop
Seat 5: sw_iceman (button) folded before Flop (didn't bet)
Seat 6: Soydemimami (small blind) showed [Ad Ac] and won ($102.65) with a pair of Aces


PokerStars Hand #208976921255:  Hold'em No Limit ($0.25/$0.50 USD) - 2020/02/08 11:51:31 ET
Table 'Acamar V' 6-max Seat #3 is the button
Seat 3: markas1996 ($50 in chips)
Seat 4: DerFlotti ($57.64 in chips)
Seat 6: Soydemimami ($174.47 in chips)
DerFlotti: posts small blind $0.25
sw_iceman: is sitting out
Soydemimami: posts big blind $0.50
*** HOLE CARDS ***
markas1996: raises $0.75 to $1.25
sw_iceman leaves the table
DerFlotti: folds
Soydemimami: calls $0.75
*** FLOP *** [9d Kc 2d]
Soydemimami: checks
markas1996: bets $0.65
Soydemimami: calls $0.65
*** TURN *** [9d Kc 2d] [5s]
Soydemimami: checks
markas1996: checks
*** RIVER *** [9d Kc 2d 5s] [7h]
Soydemimami: bets $1.93
markas1996: calls $1.93
*** SHOW DOWN ***
Soydemimami: shows [8c Kh] (a pair of Kings)
markas1996: shows [8h Ks] (a pair of Kings)
Soydemimami collected $3.76 from pot
markas1996 collected $3.75 from pot
*** SUMMARY ***
Total pot $7.91 | Rake $0.40
Board [9d Kc 2d 5s 7h]
Seat 3: markas1996 (button) showed [8h Ks] and won ($3.75) with a pair of Kings
Seat 4: DerFlotti (small blind) folded before Flop
Seat 6: Soydemimami (big blind) showed [8c Kh] and won ($3.76) with a pair of Kings


PokerStars Hand #208976970339:  Hold'em No Limit ($0.25/$0.50 USD) - 2020/02/08 11:53:03 ET
Table 'Acamar V' 6-max Seat #6 is the button
Seat 2: el2254 ($31.35 in chips)
Seat 3: mizerysage ($50 in chips)
Seat 4: DerFlotti ($55.80 in chips)
Seat 6: Soydemimami ($176.10 in chips)
el2254: posts small blind $0.25
mizerysage: posts big blind $0.50
malabar357: sits out
*** HOLE CARDS ***
DerFlotti: raises $1 to $1.50
Soydemimami: folds
el2254: folds
mizerysage: folds
Uncalled bet ($1) returned to DerFlotti
DerFlotti collected $1.25 from pot
DerFlotti: doesn't show hand
*** SUMMARY ***
Total pot $1.25 | Rake $0
Seat 2: el2254 (small blind) folded before Flop
Seat 3: mizerysage (big blind) folded before Flop
Seat 4: DerFlotti collected ($1.25)
Seat 6: Soydemimami (button) folded before Flop (didn't bet)


PokerStars Hand #208976964359:  Hold'em No Limit ($0.25/$0.50 USD) - 2020/02/08 11:52:52 ET
Table 'Acamar V' 6-max Seat #4 is the button
Seat 2: el2254 ($31.85 in chips)
Seat 4: DerFlotti ($55.80 in chips)
Seat 6: Soydemimami ($175.60 in chips)
Soydemimami: posts small blind $0.25
el2254: posts big blind $0.50
mizerysage: sits out
*** HOLE CARDS ***
DerFlotti: folds
Soydemimami: raises $1 to $1.50
el2254: folds
Uncalled bet ($1) returned to Soydemimami
Soydemimami collected $1 from pot
*** SUMMARY ***
Total pot $1 | Rake $0
Seat 2: el2254 (big blind) folded before Flop
Seat 4: DerFlotti (button) folded before Flop (didn't bet)
Seat 6: Soydemimami (small blind) collected ($1)


PokerStars Hand #208976978252:  Hold'em No Limit ($0.25/$0.50 USD) - 2020/02/08 11:53:18 ET
Table 'Acamar V' 6-max Seat #2 is the button
Seat 2: el2254 ($31.10 in chips)
Seat 3: mizerysage ($50 in chips)
Seat 4: DerFlotti ($56.55 in chips)
Seat 6: Soydemimami ($176.10 in chips)
mizerysage: posts small blind $0.25
DerFlotti: posts big blind $0.50
malabar357: sits out
dorzund: sits out
*** HOLE CARDS ***
Soydemimami: folds
el2254: calls $0.50
mizerysage: raises $2 to $2.50
DerFlotti: folds
el2254: folds
Uncalled bet ($2) returned to mizerysage
mizerysage collected $1.50 from pot
mizerysage: doesn't show hand
*** SUMMARY ***
Total pot $1.50 | Rake $0
Seat 2: el2254 (button) folded before Flop
Seat 3: mizerysage (small blind) collected ($1.50)
Seat 4: DerFlotti (big blind) folded before Flop
Seat 6: Soydemimami folded before Flop (didn't bet)


PokerStars Hand #208977000199:  Hold'em No Limit ($0.25/$0.50 USD) - 2020/02/08 11:53:59 ET
Table 'Acamar V' 6-max Seat #5 is the button
Seat 1: dorzund ($50 in chips)
Seat 2: el2254 ($31.29 in chips)
Seat 3: mizerysage ($51 in chips)
Seat 5: malabar357 ($50 in chips)
Seat 6: Soydemimami ($176.10 in chips)
Soydemimami: posts small blind $0.25
dorzund: posts big blind $0.50
*** HOLE CARDS ***
el2254: folds
mizerysage: folds
malabar357: raises $0.75 to $1.25
Soydemimami: folds
dorzund: folds
Uncalled bet ($0.75) returned to malabar357
malabar357 collected $1.25 from pot
*** SUMMARY ***
Total pot $1.25 | Rake $0
Seat 1: dorzund (big blind) folded before Flop
Seat 2: el2254 folded before Flop (didn't bet)
Seat 3: mizerysage folded before Flop (didn't bet)
Seat 5: malabar357 (button) collected ($1.25)
Seat 6: Soydemimami (small blind) folded before Flop


PokerStars Hand #208976985416:  Hold'em No Limit ($0.25/$0.50 USD) - 2020/02/08 11:53:32 ET
Table 'Acamar V' 6-max Seat #3 is the button
Seat 2: el2254 ($30.60 in chips)
Seat 3: mizerysage ($51 in chips)
Seat 4: DerFlotti ($56.05 in chips)
Seat 5: malabar357 ($50 in chips)
Seat 6: Soydemimami ($176.10 in chips)
DerFlotti: posts small blind $0.25
malabar357: posts big blind $0.50
dorzund: sits out
*** HOLE CARDS ***
Soydemimami: folds
el2254: calls $0.50
mizerysage: folds
DerFlotti: folds
malabar357: checks
*** FLOP *** [Kd 6s 7s]
malabar357: checks
el2254: bets $1.50
malabar357: folds
Uncalled bet ($1.50) returned to el2254
el2254 collected $1.19 from pot
el2254: doesn't show hand
*** SUMMARY ***
Total pot $1.25 | Rake $0.06
Board [Kd 6s 7s]
Seat 2: el2254 collected ($1.19)
Seat 3: mizerysage (button) folded before Flop (didn't bet)
Seat 4: DerFlotti (small blind) folded before Flop
Seat 5: malabar357 (big blind) folded on the Flop
Seat 6: Soydemimami folded before Flop (didn't bet)


PokerStars Hand #208977010672:  Hold'em No Limit ($0.25/$0.50 USD) - 2020/02/08 11:54:19 ET
Table 'Acamar V' 6-max Seat #6 is the button
Seat 1: dorzund ($50 in chips)
Seat 2: el2254 ($31.29 in chips)
Seat 3: mizerysage ($51 in chips)
Seat 5: malabar357 ($50.75 in chips)
Seat 6: Soydemimami ($175.85 in chips)
dorzund: posts small blind $0.25
el2254: posts big blind $0.50
*** HOLE CARDS ***
mizerysage: raises $0.80 to $1.30
malabar357: folds
Soydemimami: raises $3.20 to $4.50
dorzund: folds
el2254: folds
mizerysage: folds
Uncalled bet ($3.20) returned to Soydemimami
Soydemimami collected $3.35 from pot
Soydemimami: doesn't show hand
*** SUMMARY ***
Total pot $3.35 | Rake $0
Seat 1: dorzund (small blind) folded before Flop
Seat 2: el2254 (big blind) folded before Flop
Seat 3: mizerysage folded before Flop
Seat 5: malabar357 folded before Flop (didn't bet)
Seat 6: Soydemimami (button) collected ($3.35)


PokerStars Hand #208977019263:  Hold'em No Limit ($0.25/$0.50 USD) - 2020/02/08 11:54:35 ET
Table 'Acamar V' 6-max Seat #1 is the button
Seat 1: dorzund ($50 in chips)
Seat 2: el2254 ($30.79 in chips)
Seat 3: mizerysage ($50 in chips)
Seat 5: malabar357 ($50.75 in chips)
Seat 6: Soydemimami ($177.90 in chips)
el2254: posts small blind $0.25
mizerysage: posts big blind $0.50
*** HOLE CARDS ***
malabar357: raises $1 to $1.50
Soydemimami: folds
dorzund: folds
el2254: folds
mizerysage: calls $1
*** FLOP *** [9c 3s 2c]
mizerysage: checks
malabar357: checks
*** TURN *** [9c 3s 2c] [9d]
mizerysage: bets $1.55
malabar357: calls $1.55
*** RIVER *** [9c 3s 2c 9d] [Qc]
mizerysage: bets $4.52
malabar357: calls $4.52
*** SHOW DOWN ***
mizerysage: shows [4s 5s] (a pair of Nines)
malabar357: shows [Qd As] (two pair, Queens and Nines)
malabar357 collected $14.62 from pot
*** SUMMARY ***
Total pot $15.39 | Rake $0.77
Board [9c 3s 2c 9d Qc]
Seat 1: dorzund (button) folded before Flop (didn't bet)
Seat 2: el2254 (small blind) folded before Flop
Seat 3: mizerysage (big blind) showed [4s 5s] and lost with a pair of Nines
Seat 5: malabar357 showed [Qd As] and won ($14.62) with two pair, Queens and Nines
Seat 6: Soydemimami folded before Flop (didn't bet)


PokerStars Hand #208977038173:  Hold'em No Limit ($0.25/$0.50 USD) - 2020/02/08 11:55:10 ET
Table 'Acamar V' 6-max Seat #2 is the button
Seat 1: dorzund ($50 in chips)
Seat 2: el2254 ($30.54 in chips)
Seat 3: mizerysage ($50 in chips)
Seat 4: DerFlotti ($55.80 in chips)
Seat 5: malabar357 ($57.80 in chips)
Seat 6: Soydemimami ($177.90 in chips)
mizerysage: posts small blind $0.25
DerFlotti: posts big blind $0.50
*** HOLE CARDS ***
malabar357: folds
Soydemimami: folds
dorzund: folds
el2254: raises $0.50 to $1
mizerysage: raises $4 to $5
DerFlotti: folds
el2254: calls $4
*** FLOP *** [Tc Js 5h]
mizerysage: bets $3.99
el2254: raises $3.99 to $7.98
mizerysage: folds
Uncalled bet ($3.99) returned to el2254
el2254 collected $17.56 from pot
el2254: doesn't show hand
*** SUMMARY ***
Total pot $18.48 | Rake $0.92
Board [Tc Js 5h]
Seat 1: dorzund folded before Flop (didn't bet)
Seat 2: el2254 (button) collected ($17.56)
Seat 3: mizerysage (small blind) folded on the Flop
Seat 4: DerFlotti (big blind) folded before Flop
Seat 5: malabar357 folded before Flop (didn't bet)
Seat 6: Soydemimami folded before Flop (didn't bet)


PokerStars Hand #208977049476:  Hold'em No Limit ($0.25/$0.50 USD) - 2020/02/08 11:55:37 ET
Table 'Acamar V' 6-max Seat #3 is the button
Seat 1: dorzund ($50 in chips)
Seat 2: el2254 ($39.11 in chips)
Seat 3: mizerysage ($50 in chips)
Seat 4: DerFlotti ($55.30 in chips)
Seat 5: malabar357 ($57.80 in chips)
Seat 6: Soydemimami ($177.90 in chips)
DerFlotti: posts small blind $0.25
malabar357: posts big blind $0.50
*** HOLE CARDS ***
Soydemimami: folds
dorzund: folds
el2254: folds
mizerysage: folds
DerFlotti: calls $0.25
malabar357: checks
*** FLOP *** [Kd Kh Qc]
DerFlotti: checks
malabar357: checks
*** TURN *** [Kd Kh Qc] [4s]
DerFlotti: checks
malabar357: checks
*** RIVER *** [Kd Kh Qc 4s] [Ah]
DerFlotti: checks
malabar357: checks
*** SHOW DOWN ***
DerFlotti: shows [6c 8c] (a pair of Kings)
malabar357: mucks hand
DerFlotti collected $0.95 from pot
*** SUMMARY ***
Total pot $1 | Rake $0.05
Board [Kd Kh Qc 4s Ah]
Seat 1: dorzund folded before Flop (didn't bet)
Seat 2: el2254 folded before Flop (didn't bet)
Seat 3: mizerysage (button) folded before Flop (didn't bet)
Seat 4: DerFlotti (small blind) showed [6c 8c] and won ($0.95) with a pair of Kings
Seat 5: malabar357 (big blind) mucked
Seat 6: Soydemimami folded before Flop (didn't bet)


PokerStars Hand #208977068547:  Hold'em No Limit ($0.25/$0.50 USD) - 2020/02/08 11:56:24 ET
Table 'Acamar V' 6-max Seat #4 is the button
Seat 1: dorzund ($50 in chips)
Seat 2: el2254 ($39.11 in chips)
Seat 3: mizerysage ($50 in chips)
Seat 4: DerFlotti ($55.75 in chips)
Seat 5: malabar357 ($57.30 in chips)
Seat 6: Soydemimami ($177.90 in chips)
malabar357: posts small blind $0.25
Soydemimami: posts big blind $0.50
*** HOLE CARDS ***
dorzund: folds
el2254: folds
mizerysage: folds
DerFlotti: folds
malabar357: folds
Uncalled bet ($0.25) returned to Soydemimami
Soydemimami collected $0.50 from pot
*** SUMMARY ***
Total pot $0.50 | Rake $0
Seat 1: dorzund folded before Flop (didn't bet)
Seat 2: el2254 folded before Flop (didn't bet)
Seat 3: mizerysage folded before Flop (didn't bet)
Seat 4: DerFlotti (button) folded before Flop (didn't bet)
Seat 5: malabar357 (small blind) folded before Flop
Seat 6: Soydemimami (big blind) collected ($0.50)


PokerStars Hand #208977077197:  Hold'em No Limit ($0.25/$0.50 USD) - 2020/02/08 11:56:45 ET
Table 'Acamar V' 6-max Seat #5 is the button
Seat 1: dorzund ($50 in chips)
Seat 2: el2254 ($39.11 in chips)
Seat 3: mizerysage ($50 in chips)
Seat 4: DerFlotti ($55.75 in chips)
Seat 5: malabar357 ($57.05 in chips)
Seat 6: Soydemimami ($178.15 in chips)
Soydemimami: posts small blind $0.25
dorzund: posts big blind $0.50
*** HOLE CARDS ***
el2254: folds
mizerysage: folds
DerFlotti: raises $1 to $1.50
malabar357: folds
Soydemimami: folds
dorzund: folds
Uncalled bet ($1) returned to DerFlotti
DerFlotti collected $1.25 from pot
DerFlotti: doesn't show hand
*** SUMMARY ***
Total pot $1.25 | Rake $0
Seat 1: dorzund (big blind) folded before Flop
Seat 2: el2254 folded before Flop (didn't bet)
Seat 3: mizerysage folded before Flop (didn't bet)
Seat 4: DerFlotti collected ($1.25)
Seat 5: malabar357 (button) folded before Flop (didn't bet)
Seat 6: Soydemimami (small blind) folded before Flop


PokerStars Hand #208977083316:  Hold'em No Limit ($0.25/$0.50 USD) - 2020/02/08 11:57:00 ET
Table 'Acamar V' 6-max Seat #6 is the button
Seat 1: dorzund ($50 in chips)
Seat 2: el2254 ($39.11 in chips)
Seat 3: mizerysage ($50 in chips)
Seat 4: DerFlotti ($56.50 in chips)
Seat 5: malabar357 ($57.05 in chips)
Seat 6: Soydemimami ($177.90 in chips)
dorzund: posts small blind $0.25
el2254: posts big blind $0.50
*** HOLE CARDS ***
mizerysage: folds
DerFlotti: folds
malabar357: folds
Soydemimami: folds
dorzund: raises $0.75 to $1.25
el2254: calls $0.75
*** FLOP *** [8c Ah 2d]
mizerysage leaves the table
dorzund: bets $1.19
el2254: calls $1.19
*** TURN *** [8c Ah 2d] [8h]
dorzund: checks
el2254: checks
*** RIVER *** [8c Ah 2d 8h] [8s]
dorzund: checks
el2254: bets $0.50
dorzund: folds
Uncalled bet ($0.50) returned to el2254
el2254 collected $4.64 from pot
el2254: doesn't show hand
*** SUMMARY ***
Total pot $4.88 | Rake $0.24
Board [8c Ah 2d 8h 8s]
Seat 1: dorzund (small blind) folded on the River
Seat 2: el2254 (big blind) collected ($4.64)
Seat 3: mizerysage folded before Flop (didn't bet)
Seat 4: DerFlotti folded before Flop (didn't bet)
Seat 5: malabar357 folded before Flop (didn't bet)
Seat 6: Soydemimami (button) folded before Flop (didn't bet)


PokerStars Hand #208977127713:  Hold'em No Limit ($0.25/$0.50 USD) - 2020/02/08 11:58:48 ET
Table 'Acamar V' 6-max Seat #4 is the button
Seat 1: dorzund ($50 in chips)
Seat 2: el2254 ($40.56 in chips)
Seat 4: DerFlotti ($55.75 in chips)
Seat 5: malabar357 ($57.74 in chips)
Seat 6: Soydemimami ($178.65 in chips)
malabar357: posts small blind $0.25
Soydemimami: posts big blind $0.50
Glushchenko: sits out
*** HOLE CARDS ***
dorzund: folds
el2254: folds
DerFlotti: calls $0.50
malabar357: folds
Soydemimami: checks
*** FLOP *** [3s 8h 7c]
Soydemimami: checks
DerFlotti: checks
*** TURN *** [3s 8h 7c] [Jh]
Soydemimami: checks
DerFlotti: bets $0.60
Soydemimami: folds
Uncalled bet ($0.60) returned to DerFlotti
Glushchenko leaves the table
DerFlotti collected $1.19 from pot
DerFlotti: doesn't show hand
*** SUMMARY ***
Total pot $1.25 | Rake $0.06
Board [3s 8h 7c Jh]
Seat 1: dorzund folded before Flop (didn't bet)
Seat 2: el2254 folded before Flop (didn't bet)
Seat 4: DerFlotti (button) collected ($1.19)
Seat 5: malabar357 (small blind) folded before Flop
Seat 6: Soydemimami (big blind) folded on the Turn


PokerStars Hand #208977117936:  Hold'em No Limit ($0.25/$0.50 USD) - 2020/02/08 11:58:25 ET
Table 'Acamar V' 6-max Seat #2 is the button
Seat 1: dorzund ($50 in chips)
Seat 2: el2254 ($41.06 in chips)
Seat 4: DerFlotti ($56 in chips)
Seat 5: malabar357 ($57.05 in chips)
Seat 6: Soydemimami ($178.65 in chips)
DerFlotti: posts small blind $0.25
malabar357: posts big blind $0.50
*** HOLE CARDS ***
Soydemimami: folds
dorzund: folds
el2254: calls $0.50
DerFlotti: folds
malabar357: checks
*** FLOP *** [7s 8h 9h]
malabar357: bets $1
el2254: folds
Uncalled bet ($1) returned to malabar357
malabar357 collected $1.19 from pot
*** SUMMARY ***
Total pot $1.25 | Rake $0.06
Board [7s 8h 9h]
Seat 1: dorzund folded before Flop (didn't bet)
Seat 2: el2254 (button) folded on the Flop
Seat 4: DerFlotti (small blind) folded before Flop
Seat 5: malabar357 (big blind) collected ($1.19)
Seat 6: Soydemimami folded before Flop (didn't bet)


PokerStars Hand #208977111797:  Hold'em No Limit ($0.25/$0.50 USD) - 2020/02/08 11:58:10 ET
Table 'Acamar V' 6-max Seat #1 is the button
Seat 1: dorzund ($50 in chips)
Seat 2: el2254 ($41.31 in chips)
Seat 4: DerFlotti ($56.50 in chips)
Seat 5: malabar357 ($57.05 in chips)
Seat 6: Soydemimami ($177.90 in chips)
el2254: posts small blind $0.25
DerFlotti: posts big blind $0.50
*** HOLE CARDS ***
malabar357: folds
Soydemimami: raises $0.75 to $1.25
dorzund: folds
Glushchenko joins the table at seat #3
el2254: folds
DerFlotti: folds
Uncalled bet ($0.75) returned to Soydemimami
Soydemimami collected $1.25 from pot
Soydemimami: doesn't show hand
*** SUMMARY ***
Total pot $1.25 | Rake $0
Seat 1: dorzund (button) folded before Flop (didn't bet)
Seat 2: el2254 (small blind) folded before Flop
Seat 4: DerFlotti (big blind) folded before Flop
Seat 5: malabar357 folded before Flop (didn't bet)
Seat 6: Soydemimami collected ($1.25)


PokerStars Hand #208977142764:  Hold'em No Limit ($0.25/$0.50 USD) - 2020/02/08 11:59:25 ET
Table 'Acamar V' 6-max Seat #5 is the button
Seat 1: dorzund ($50 in chips)
Seat 2: el2254 ($40.56 in chips)
Seat 4: DerFlotti ($56.44 in chips)
Seat 5: malabar357 ($57.49 in chips)
Seat 6: Soydemimami ($178.15 in chips)
Soydemimami: posts small blind $0.25
dorzund: posts big blind $0.50
*** HOLE CARDS ***
el2254: folds
DerFlotti: folds
malabar357: raises $1 to $1.50
Soydemimami: folds
Emily_GetMan joins the table at seat #3
Emily_GetMan leaves the table
dorzund: folds
Uncalled bet ($1) returned to malabar357
malabar357 collected $1.25 from pot
*** SUMMARY ***
Total pot $1.25 | Rake $0
Seat 1: dorzund (big blind) folded before Flop
Seat 2: el2254 folded before Flop (didn't bet)
Seat 4: DerFlotti folded before Flop (didn't bet)
Seat 5: malabar357 (button) collected ($1.25)
Seat 6: Soydemimami (small blind) folded before Flop


PokerStars Hand #208977153129:  Hold'em No Limit ($0.25/$0.50 USD) - 2020/02/08 11:59:50 ET
Table 'Acamar V' 6-max Seat #6 is the button
Seat 1: dorzund ($50 in chips)
Seat 2: el2254 ($40.56 in chips)
Seat 4: DerFlotti ($56.44 in chips)
Seat 5: malabar357 ($58.24 in chips)
Seat 6: Soydemimami ($177.90 in chips)
dorzund: posts small blind $0.25
el2254: posts big blind $0.50
*** HOLE CARDS ***
StayFit4 joins the table at seat #3
DerFlotti: folds
malabar357: folds
Soydemimami: raises $0.50 to $1
dorzund: folds
el2254: calls $0.50
*** FLOP *** [6s As 5s]
el2254: checks
Soydemimami: bets $0.54
el2254: folds
Uncalled bet ($0.54) returned to Soydemimami
Soydemimami collected $2.14 from pot
*** SUMMARY ***
Total pot $2.25 | Rake $0.11
Board [6s As 5s]
Seat 1: dorzund (small blind) folded before Flop
Seat 2: el2254 (big blind) folded on the Flop
Seat 4: DerFlotti folded before Flop (didn't bet)
Seat 5: malabar357 folded before Flop (didn't bet)
Seat 6: Soydemimami (button) collected ($2.14)


PokerStars Hand #208977168740:  Hold'em No Limit ($0.25/$0.50 USD) - 2020/02/08 12:00:26 ET
Table 'Acamar V' 6-max Seat #1 is the button
Seat 1: dorzund ($50 in chips)
Seat 2: el2254 ($39.56 in chips)
Seat 3: StayFit4 ($50 in chips)
Seat 4: DerFlotti ($56.44 in chips)
Seat 5: malabar357 ($58.24 in chips)
Seat 6: Soydemimami ($179.04 in chips)
el2254: posts small blind $0.25
StayFit4: posts big blind $0.50
*** HOLE CARDS ***
DerFlotti: folds
malabar357: folds
Soydemimami: folds
dorzund: folds
el2254: calls $0.25
StayFit4: checks
*** FLOP *** [Qd Ks 5c]
el2254: checks
StayFit4: checks
*** TURN *** [Qd Ks 5c] [8d]
el2254: checks
StayFit4: bets $0.58
el2254: calls $0.58
*** RIVER *** [Qd Ks 5c 8d] [Qs]
el2254: checks
StayFit4: checks
*** SHOW DOWN ***
el2254: shows [3c 3s] (two pair, Queens and Threes)
StayFit4: mucks hand
el2254 collected $2.05 from pot
*** SUMMARY ***
Total pot $2.16 | Rake $0.11
Board [Qd Ks 5c 8d Qs]
Seat 1: dorzund (button) folded before Flop (didn't bet)
Seat 2: el2254 (small blind) showed [3c 3s] and won ($2.05) with two pair, Queens and Threes
Seat 3: StayFit4 (big blind) mucked
Seat 4: DerFlotti folded before Flop (didn't bet)
Seat 5: malabar357 folded before Flop (didn't bet)
Seat 6: Soydemimami folded before Flop (didn't bet)


PokerStars Hand #208977189811:  Hold'em No Limit ($0.25/$0.50 USD) - 2020/02/08 12:01:13 ET
Table 'Acamar V' 6-max Seat #2 is the button
Seat 1: dorzund ($50 in chips)
Seat 2: el2254 ($40.53 in chips)
Seat 3: StayFit4 ($50 in chips)
Seat 4: DerFlotti ($56.44 in chips)
Seat 5: malabar357 ($58.24 in chips)
Seat 6: Soydemimami ($179.04 in chips)
StayFit4: posts small blind $0.25
DerFlotti: posts big blind $0.50
*** HOLE CARDS ***
malabar357: folds
Soydemimami: folds
dorzund: folds
el2254: folds
StayFit4: folds
Uncalled bet ($0.25) returned to DerFlotti
DerFlotti collected $0.50 from pot
DerFlotti: doesn't show hand
*** SUMMARY ***
Total pot $0.50 | Rake $0
Seat 1: dorzund folded before Flop (didn't bet)
Seat 2: el2254 (button) folded before Flop (didn't bet)
Seat 3: StayFit4 (small blind) folded before Flop
Seat 4: DerFlotti (big blind) collected ($0.50)
Seat 5: malabar357 folded before Flop (didn't bet)
Seat 6: Soydemimami folded before Flop (didn't bet)


PokerStars Hand #208977194918:  Hold'em No Limit ($0.25/$0.50 USD) - 2020/02/08 12:01:23 ET
Table 'Acamar V' 6-max Seat #3 is the button
Seat 1: dorzund ($50 in chips)
Seat 2: el2254 ($40.53 in chips)
Seat 3: StayFit4 ($50 in chips)
Seat 4: DerFlotti ($56.69 in chips)
Seat 6: Soydemimami ($179.04 in chips)
DerFlotti: posts small blind $0.25
malabar357: is sitting out
Soydemimami: posts big blind $0.50
*** HOLE CARDS ***
malabar357 leaves the table
dorzund: folds
el2254: folds
StayFit4: folds
DerFlotti: calls $0.25
LitviN88 joins the table at seat #5
Soydemimami: raises $2.50 to $3
DerFlotti: calls $2.50
*** FLOP *** [2c 4h 5h]
DerFlotti: checks
Soydemimami: bets $2.85
DerFlotti: folds
Uncalled bet ($2.85) returned to Soydemimami
Soydemimami collected $5.70 from pot
*** SUMMARY ***
Total pot $6 | Rake $0.30
Board [2c 4h 5h]
Seat 1: dorzund folded before Flop (didn't bet)
Seat 2: el2254 folded before Flop (didn't bet)
Seat 3: StayFit4 (button) folded before Flop (didn't bet)
Seat 4: DerFlotti (small blind) folded on the Flop
Seat 6: Soydemimami (big blind) collected ($5.70)


PokerStars Hand #208977211162:  Hold'em No Limit ($0.25/$0.50 USD) - 2020/02/08 12:01:56 ET
Table 'Acamar V' 6-max Seat #4 is the button
Seat 1: dorzund ($50 in chips)
Seat 2: el2254 ($40.53 in chips)
Seat 3: StayFit4 ($50 in chips)
Seat 4: DerFlotti ($53.69 in chips)
Seat 6: Soydemimami ($181.74 in chips)
Soydemimami: posts small blind $0.25
dorzund: posts big blind $0.50
*** HOLE CARDS ***
el2254: folds
StayFit4: folds
DerFlotti: folds
Soydemimami: raises $1 to $1.50
dorzund: folds
Uncalled bet ($1) returned to Soydemimami
Soydemimami collected $1 from pot
*** SUMMARY ***
Total pot $1 | Rake $0
Seat 1: dorzund (big blind) folded before Flop
Seat 2: el2254 folded before Flop (didn't bet)
Seat 3: StayFit4 folded before Flop (didn't bet)
Seat 4: DerFlotti (button) folded before Flop (didn't bet)
Seat 6: Soydemimami (small blind) collected ($1)


PokerStars Hand #208977221866:  Hold'em No Limit ($0.25/$0.50 USD) - 2020/02/08 12:02:16 ET
Table 'Acamar V' 6-max Seat #6 is the button
Seat 1: dorzund ($50 in chips)
Seat 2: el2254 ($40.53 in chips)
Seat 3: StayFit4 ($50 in chips)
Seat 4: DerFlotti ($53.69 in chips)
Seat 6: Soydemimami ($182.24 in chips)
dorzund: posts small blind $0.25
el2254: posts big blind $0.50
LitviN88: sits out
*** HOLE CARDS ***
LitviN88 leaves the table
StayFit4: folds
StayFit4 leaves the table
DerFlotti: raises $1 to $1.50
Soydemimami: folds
dorzund: folds
el2254: folds
Uncalled bet ($1) returned to DerFlotti
DerFlotti collected $1.25 from pot
DerFlotti: doesn't show hand
*** SUMMARY ***
Total pot $1.25 | Rake $0
Seat 1: dorzund (small blind) folded before Flop
Seat 2: el2254 (big blind) folded before Flop
Seat 3: StayFit4 folded before Flop (didn't bet)
Seat 4: DerFlotti collected ($1.25)
Seat 6: Soydemimami (button) folded before Flop (didn't bet)


PokerStars Hand #208977251543:  Hold'em No Limit ($0.25/$0.50 USD) - 2020/02/08 12:03:10 ET
Table 'Acamar V' 6-max Seat #2 is the button
Seat 1: dorzund ($50 in chips)
Seat 2: el2254 ($38.78 in chips)
Seat 4: DerFlotti ($53.94 in chips)
Seat 5: Gatyer14 ($50 in chips)
Seat 6: Soydemimami ($183.84 in chips)
DerFlotti: posts small blind $0.25
Gatyer14: posts big blind $0.50
*** HOLE CARDS ***
Soydemimami: folds
dorzund: folds
el2254: folds
DerFlotti: raises $1 to $1.50
barrrrygold leaves the table
Gatyer14: folds
Uncalled bet ($1) returned to DerFlotti
DerFlotti collected $1 from pot
DerFlotti: doesn't show hand
*** SUMMARY ***
Total pot $1 | Rake $0
Seat 1: dorzund folded before Flop (didn't bet)
Seat 2: el2254 (button) folded before Flop (didn't bet)
Seat 4: DerFlotti (small blind) collected ($1)
Seat 5: Gatyer14 (big blind) folded before Flop
Seat 6: Soydemimami folded before Flop (didn't bet)


PokerStars Hand #208977230973:  Hold'em No Limit ($0.25/$0.50 USD) - 2020/02/08 12:02:33 ET
Table 'Acamar V' 6-max Seat #1 is the button
Seat 1: dorzund ($50 in chips)
Seat 2: el2254 ($40.03 in chips)
Seat 4: DerFlotti ($54.44 in chips)
Seat 6: Soydemimami ($182.24 in chips)
el2254: posts small blind $0.25
DerFlotti: posts big blind $0.50
*** HOLE CARDS ***
barrrrygold joins the table at seat #3
Soydemimami: raises $0.75 to $1.25
dorzund: folds
el2254: calls $1
DerFlotti: folds
*** FLOP *** [3s 8h 6s]
Gatyer14 joins the table at seat #5
el2254: checks
Soydemimami: checks
*** TURN *** [3s 8h 6s] [Jc]
el2254: checks
Soydemimami: bets $2
el2254: folds
Uncalled bet ($2) returned to Soydemimami
Soydemimami collected $2.85 from pot
*** SUMMARY ***
Total pot $3 | Rake $0.15
Board [3s 8h 6s Jc]
Seat 1: dorzund (button) folded before Flop (didn't bet)
Seat 2: el2254 (small blind) folded on the Turn
Seat 4: DerFlotti (big blind) folded before Flop
Seat 6: Soydemimami collected ($2.85)


PokerStars Hand #208977262541:  Hold'em No Limit ($0.25/$0.50 USD) - 2020/02/08 12:03:26 ET
Table 'Acamar V' 6-max Seat #4 is the button
Seat 1: dorzund ($50 in chips)
Seat 2: el2254 ($38.78 in chips)
Seat 4: DerFlotti ($54.44 in chips)
Seat 5: Gatyer14 ($50 in chips)
Seat 6: Soydemimami ($183.84 in chips)
Gatyer14: posts small blind $0.25
Soydemimami: posts big blind $0.50
*** HOLE CARDS ***
dorzund: folds
el2254: calls $0.50
DerFlotti: folds
Gatyer14: raises $1.50 to $2
Soydemimami: folds
el2254: calls $1.50
*** FLOP *** [6h 3s Jc]
gutacho joins the table at seat #3
Gatyer14: bets $1.41
el2254: calls $1.41
*** TURN *** [6h 3s Jc] [8s]
Gatyer14: checks
el2254: bets $1
Gatyer14: calls $1
*** RIVER *** [6h 3s Jc 8s] [2c]
Gatyer14: checks
el2254: checks
*** SHOW DOWN ***
Gatyer14: shows [Qd Ad] (high card Ace)
el2254: shows [Qh Js] (a pair of Jacks)
el2254 collected $8.85 from pot
*** SUMMARY ***
Total pot $9.32 | Rake $0.47
Board [6h 3s Jc 8s 2c]
Seat 1: dorzund folded before Flop (didn't bet)
Seat 2: el2254 showed [Qh Js] and won ($8.85) with a pair of Jacks
Seat 4: DerFlotti (button) folded before Flop (didn't bet)
Seat 5: Gatyer14 (small blind) showed [Qd Ad] and lost with high card Ace
Seat 6: Soydemimami (big blind) folded before Flop


PokerStars Hand #208977309205:  Hold'em No Limit ($0.25/$0.50 USD) - 2020/02/08 12:04:51 ET
Table 'Acamar V' 6-max Seat #5 is the button
Seat 1: dorzund ($50 in chips)
Seat 2: el2254 ($43.22 in chips)
Seat 4: DerFlotti ($54.44 in chips)
Seat 5: Gatyer14 ($50 in chips)
Seat 6: Soydemimami ($183.34 in chips)
Soydemimami: posts small blind $0.25
dorzund: posts big blind $0.50
gutacho: sits out
*** HOLE CARDS ***
el2254: folds
DerFlotti: folds
Gatyer14: folds
Soydemimami: raises $1 to $1.50
dorzund: folds
Uncalled bet ($1) returned to Soydemimami
Soydemimami collected $1 from pot
*** SUMMARY ***
Total pot $1 | Rake $0
Seat 1: dorzund (big blind) folded before Flop
Seat 2: el2254 folded before Flop (didn't bet)
Seat 4: DerFlotti folded before Flop (didn't bet)
Seat 5: Gatyer14 (button) folded before Flop (didn't bet)
Seat 6: Soydemimami (small blind) collected ($1)


PokerStars Hand #208977350805:  Hold'em No Limit ($0.25/$0.50 USD) - 2020/02/08 12:06:05 ET
Table 'Acamar V' 6-max Seat #3 is the button
Seat 1: dorzund ($50 in chips)
Seat 2: el2254 ($42.47 in chips)
Seat 3: gutacho ($50 in chips)
Seat 5: Gatyer14 ($50 in chips)
Seat 6: Soydemimami ($189.59 in chips)
Gatyer14: posts small blind $0.25
Soydemimami: posts big blind $0.50
*** HOLE CARDS ***
dorzund: folds
el2254: folds
gutacho: raises $1.25 to $1.75
Gatyer14: folds
Soydemimami: calls $1.25
*** FLOP *** [Qs 6c 2d]
Soydemimami: checks
gutacho: bets $3.50
Soydemimami: calls $3.50
*** TURN *** [Qs 6c 2d] [4d]
Soydemimami: checks
gutacho: checks
*** RIVER *** [Qs 6c 2d 4d] [2c]
Soydemimami: bets $3.37
gutacho: folds
Uncalled bet ($3.37) returned to Soydemimami
Soydemimami collected $10.21 from pot
*** SUMMARY ***
Total pot $10.75 | Rake $0.54
Board [Qs 6c 2d 4d 2c]
Seat 1: dorzund folded before Flop (didn't bet)
Seat 2: el2254 folded before Flop (didn't bet)
Seat 3: gutacho (button) folded on the River
Seat 5: Gatyer14 (small blind) folded before Flop
Seat 6: Soydemimami (big blind) collected ($10.21)


PokerStars Hand #208977317835:  Hold'em No Limit ($0.25/$0.50 USD) - 2020/02/08 12:05:06 ET
Table 'Acamar V' 6-max Seat #6 is the button
Seat 1: dorzund ($50 in chips)
Seat 2: el2254 ($43.22 in chips)
Seat 4: DerFlotti ($54.44 in chips)
Seat 5: Gatyer14 ($50 in chips)
Seat 6: Soydemimami ($183.84 in chips)
dorzund: posts small blind $0.25
el2254: posts big blind $0.50
gutacho: sits out
*** HOLE CARDS ***
DerFlotti: folds
Gatyer14: folds
Soydemimami: raises $0.50 to $1
dorzund: raises $3.50 to $4.50
el2254: folds
Soydemimami: raises $7.50 to $12
dorzund: folds
Uncalled bet ($7.50) returned to Soydemimami
Soydemimami collected $9.50 from pot
Soydemimami: doesn't show hand
*** SUMMARY ***
Total pot $9.50 | Rake $0
Seat 1: dorzund (small blind) folded before Flop
Seat 2: el2254 (big blind) folded before Flop
Seat 4: DerFlotti folded before Flop (didn't bet)
Seat 5: Gatyer14 folded before Flop (didn't bet)
Seat 6: Soydemimami (button) collected ($9.50)


PokerStars Hand #208977337058:  Hold'em No Limit ($0.25/$0.50 USD) - 2020/02/08 12:05:41 ET
Table 'Acamar V' 6-max Seat #1 is the button
Seat 1: dorzund ($50 in chips)
Seat 2: el2254 ($42.72 in chips)
Seat 3: gutacho ($50 in chips)
Seat 5: Gatyer14 ($50 in chips)
Seat 6: Soydemimami ($188.84 in chips)
el2254: posts small blind $0.25
gutacho: posts big blind $0.50
*** HOLE CARDS ***
Gatyer14: folds
Soydemimami: raises $0.75 to $1.25
dorzund: folds
el2254: folds
gutacho: folds
Uncalled bet ($0.75) returned to Soydemimami
Soydemimami collected $1.25 from pot
Soydemimami: doesn't show hand
*** SUMMARY ***
Total pot $1.25 | Rake $0
Seat 1: dorzund (button) folded before Flop (didn't bet)
Seat 2: el2254 (small blind) folded before Flop
Seat 3: gutacho (big blind) folded before Flop
Seat 5: Gatyer14 folded before Flop (didn't bet)
Seat 6: Soydemimami collected ($1.25)


PokerStars Hand #208977343711:  Hold'em No Limit ($0.25/$0.50 USD) - 2020/02/08 12:05:52 ET
Table 'Acamar V' 6-max Seat #2 is the button
Seat 1: dorzund ($50 in chips)
Seat 2: el2254 ($42.47 in chips)
Seat 3: gutacho ($49.50 in chips)
Seat 5: Gatyer14 ($50 in chips)
Seat 6: Soydemimami ($189.59 in chips)
gutacho: posts small blind $0.25
Gatyer14: posts big blind $0.50
*** HOLE CARDS ***
Soydemimami: folds
dorzund: folds
el2254: folds
gutacho: raises $1 to $1.50
Gatyer14: folds
Uncalled bet ($1) returned to gutacho
gutacho collected $1 from pot
gutacho: doesn't show hand
*** SUMMARY ***
Total pot $1 | Rake $0
Seat 1: dorzund folded before Flop (didn't bet)
Seat 2: el2254 (button) folded before Flop (didn't bet)
Seat 3: gutacho (small blind) collected ($1)
Seat 5: Gatyer14 (big blind) folded before Flop
Seat 6: Soydemimami folded before Flop (didn't bet)


PokerStars Hand #208977373299:  Hold'em No Limit ($0.25/$0.50 USD) - 2020/02/08 12:06:45 ET
Table 'Acamar V' 6-max Seat #6 is the button
Seat 2: el2254 ($41.97 in chips)
Seat 3: gutacho ($44.75 in chips)
Seat 5: Gatyer14 ($50 in chips)
Seat 6: Soydemimami ($195.05 in chips)
el2254: posts small blind $0.25
gutacho: posts big blind $0.50
DerFlotti: sits out
*** HOLE CARDS ***
Gatyer14: folds
Soydemimami: raises $0.50 to $1
el2254: calls $0.75
gutacho: calls $0.50
*** FLOP *** [Qc Js 2c]
el2254: bets $1
gutacho: raises $2 to $3
Soydemimami: folds
el2254: folds
Uncalled bet ($2) returned to gutacho
gutacho collected $4.75 from pot
gutacho: doesn't show hand
*** SUMMARY ***
Total pot $5 | Rake $0.25
Board [Qc Js 2c]
Seat 2: el2254 (small blind) folded on the Flop
Seat 3: gutacho (big blind) collected ($4.75)
Seat 5: Gatyer14 folded before Flop (didn't bet)
Seat 6: Soydemimami (button) folded on the Flop


PokerStars Hand #208977366287:  Hold'em No Limit ($0.25/$0.50 USD) - 2020/02/08 12:06:33 ET
Table 'Acamar V' 6-max Seat #5 is the button
Seat 2: el2254 ($42.47 in chips)
Seat 3: gutacho ($44.75 in chips)
Seat 5: Gatyer14 ($50 in chips)
Seat 6: Soydemimami ($194.55 in chips)
Soydemimami: posts small blind $0.25
dorzund: is sitting out
el2254: posts big blind $0.50
DerFlotti: sits out
*** HOLE CARDS ***
dorzund leaves the table
Alpha&OmegaB joins the table at seat #1
gutacho: folds
Gatyer14: folds
Soydemimami: raises $1 to $1.50
el2254: folds
Uncalled bet ($1) returned to Soydemimami
Soydemimami collected $1 from pot
*** SUMMARY ***
Total pot $1 | Rake $0
Seat 2: el2254 (big blind) folded before Flop
Seat 3: gutacho folded before Flop (didn't bet)
Seat 5: Gatyer14 (button) folded before Flop (didn't bet)
Seat 6: Soydemimami (small blind) collected ($1)


PokerStars Hand #208977398380:  Hold'em No Limit ($0.25/$0.50 USD) - 2020/02/08 12:07:30 ET
Table 'Acamar V' 6-max Seat #2 is the button
Seat 2: el2254 ($39.97 in chips)
Seat 3: gutacho ($47.50 in chips)
Seat 4: DerFlotti ($54.44 in chips)
Seat 5: Gatyer14 ($50 in chips)
Seat 6: Soydemimami ($194.05 in chips)
gutacho: posts small blind $0.25
DerFlotti: posts big blind $0.50
Alpha&OmegaB: sits out
*** HOLE CARDS ***
Alpha&OmegaB leaves the table
Gatyer14: folds
Soydemimami: folds
el2254: folds
gutacho: raises $1 to $1.50
DerFlotti: calls $1
*** FLOP *** [7h Ks 5h]
gutacho: bets $3
DerFlotti: folds
Uncalled bet ($3) returned to gutacho
gutacho collected $2.85 from pot
gutacho: doesn't show hand
*** SUMMARY ***
Total pot $3 | Rake $0.15
Board [7h Ks 5h]
Seat 2: el2254 (button) folded before Flop (didn't bet)
Seat 3: gutacho (small blind) collected ($2.85)
Seat 4: DerFlotti (big blind) folded on the Flop
Seat 5: Gatyer14 folded before Flop (didn't bet)
Seat 6: Soydemimami folded before Flop (didn't bet)


PokerStars Hand #208977411031:  Hold'em No Limit ($0.25/$0.50 USD) - 2020/02/08 12:07:53 ET
Table 'Acamar V' 6-max Seat #3 is the button
Seat 2: el2254 ($39.97 in chips)
Seat 3: gutacho ($48.85 in chips)
Seat 4: DerFlotti ($52.94 in chips)
Seat 5: Gatyer14 ($50 in chips)
Seat 6: Soydemimami ($194.05 in chips)
DerFlotti: posts small blind $0.25
Gatyer14: posts big blind $0.50
*** HOLE CARDS ***
Soydemimami: folds
el2254: calls $0.50
gutacho: folds
DerFlotti: folds
Gatyer14: checks
*** FLOP *** [8c 4h 6c]
Gatyer14: bets $0.89
el2254: folds
Uncalled bet ($0.89) returned to Gatyer14
Gatyer14 collected $1.19 from pot
Gatyer14: doesn't show hand
*** SUMMARY ***
Total pot $1.25 | Rake $0.06
Board [8c 4h 6c]
Seat 2: el2254 folded on the Flop
Seat 3: gutacho (button) folded before Flop (didn't bet)
Seat 4: DerFlotti (small blind) folded before Flop
Seat 5: Gatyer14 (big blind) collected ($1.19)
Seat 6: Soydemimami folded before Flop (didn't bet)


PokerStars Hand #208977424590:  Hold'em No Limit ($0.25/$0.50 USD) - 2020/02/08 12:08:17 ET
Table 'Acamar V' 6-max Seat #4 is the button
Seat 2: el2254 ($39.47 in chips)
Seat 3: gutacho ($48.85 in chips)
Seat 4: DerFlotti ($52.69 in chips)
Seat 5: Gatyer14 ($50.69 in chips)
Seat 6: Soydemimami ($194.05 in chips)
Gatyer14: posts small blind $0.25
Soydemimami: posts big blind $0.50
*** HOLE CARDS ***
el2254: folds
gutacho: folds
DerFlotti: calls $0.50
Gatyer14: folds
Soydemimami: raises $2 to $2.50
DerFlotti: folds
Uncalled bet ($2) returned to Soydemimami
Soydemimami collected $1.25 from pot
*** SUMMARY ***
Total pot $1.25 | Rake $0
Seat 2: el2254 folded before Flop (didn't bet)
Seat 3: gutacho folded before Flop (didn't bet)
Seat 4: DerFlotti (button) folded before Flop
Seat 5: Gatyer14 (small blind) folded before Flop
Seat 6: Soydemimami (big blind) collected ($1.25)


PokerStars Hand #208977444507:  Hold'em No Limit ($0.25/$0.50 USD) - 2020/02/08 12:08:38 ET
Table 'Acamar V' 6-max Seat #5 is the button
Seat 2: el2254 ($39.47 in chips)
Seat 3: gutacho ($48.85 in chips)
Seat 4: DerFlotti ($52.19 in chips)
Seat 5: Gatyer14 ($50.44 in chips)
Seat 6: Soydemimami ($194.80 in chips)
Soydemimami: posts small blind $0.25
el2254: posts big blind $0.50
*** HOLE CARDS ***
gutacho: raises $1.25 to $1.75
beerjoe984 joins the table at seat #1
DerFlotti: folds
Gatyer14: folds
Soydemimami: folds
el2254: folds
Uncalled bet ($1.25) returned to gutacho
gutacho collected $1.25 from pot
gutacho: doesn't show hand
*** SUMMARY ***
Total pot $1.25 | Rake $0
Seat 2: el2254 (big blind) folded before Flop
Seat 3: gutacho collected ($1.25)
Seat 4: DerFlotti folded before Flop (didn't bet)
Seat 5: Gatyer14 (button) folded before Flop (didn't bet)
Seat 6: Soydemimami (small blind) folded before Flop


PokerStars Hand #208977484729:  Hold'em No Limit ($0.25/$0.50 USD) - 2020/02/08 12:09:50 ET
Table 'Acamar V' 6-max Seat #2 is the button
Seat 2: el2254 ($37.22 in chips)
Seat 3: gutacho ($49.10 in chips)
Seat 4: DerFlotti ($52.19 in chips)
Seat 5: Gatyer14 ($52.49 in chips)
Seat 6: Soydemimami ($194.55 in chips)
gutacho: posts small blind $0.25
DerFlotti: posts big blind $0.50
beerjoe984: sits out
*** HOLE CARDS ***
Gatyer14: raises $0.75 to $1.25
Soydemimami: folds
el2254: calls $1.25
gutacho: calls $1
DerFlotti: folds
*** FLOP *** [4h 3d 9s]
gutacho: checks
Gatyer14: bets $2.02
el2254: folds
gutacho: folds
Uncalled bet ($2.02) returned to Gatyer14
Gatyer14 collected $4.04 from pot
Gatyer14: doesn't show hand
*** SUMMARY ***
Total pot $4.25 | Rake $0.21
Board [4h 3d 9s]
Seat 2: el2254 (button) folded on the Flop
Seat 3: gutacho (small blind) folded on the Flop
Seat 4: DerFlotti (big blind) folded before Flop
Seat 5: Gatyer14 collected ($4.04)
Seat 6: Soydemimami folded before Flop (didn't bet)


PokerStars Hand #208977452649:  Hold'em No Limit ($0.25/$0.50 USD) - 2020/02/08 12:08:52 ET
Table 'Acamar V' 6-max Seat #6 is the button
Seat 2: el2254 ($38.97 in chips)
Seat 3: gutacho ($49.60 in chips)
Seat 4: DerFlotti ($52.19 in chips)
Seat 5: Gatyer14 ($50.44 in chips)
Seat 6: Soydemimami ($194.55 in chips)
el2254: posts small blind $0.25
gutacho: posts big blind $0.50
*** HOLE CARDS ***
DerFlotti: folds
Gatyer14: raises $0.75 to $1.25
Soydemimami: folds
el2254: calls $1
gutacho: folds
*** FLOP *** [Ks 7c 5d]
el2254: checks
Gatyer14: checks
*** TURN *** [Ks 7c 5d] [Kh]
el2254: bets $0.50
Gatyer14: raises $2.89 to $3.39
el2254: folds
Uncalled bet ($2.89) returned to Gatyer14
Gatyer14 collected $3.80 from pot
Gatyer14: doesn't show hand
*** SUMMARY ***
Total pot $4 | Rake $0.20
Board [Ks 7c 5d Kh]
Seat 2: el2254 (small blind) folded on the Turn
Seat 3: gutacho (big blind) folded before Flop
Seat 4: DerFlotti folded before Flop (didn't bet)
Seat 5: Gatyer14 collected ($3.80)
Seat 6: Soydemimami (button) folded before Flop (didn't bet)


PokerStars Hand #208977498795:  Hold'em No Limit ($0.25/$0.50 USD) - 2020/02/08 12:10:15 ET
Table 'Acamar V' 6-max Seat #3 is the button
Seat 2: el2254 ($35.97 in chips)
Seat 3: gutacho ($47.85 in chips)
Seat 4: DerFlotti ($51.69 in chips)
Seat 5: Gatyer14 ($55.28 in chips)
Seat 6: Soydemimami ($194.55 in chips)
DerFlotti: posts small blind $0.25
Gatyer14: posts big blind $0.50
beerjoe984: sits out
*** HOLE CARDS ***
Soydemimami: raises $0.75 to $1.25
el2254: calls $1.25
gutacho: folds
DerFlotti: folds
Gatyer14: folds
*** FLOP *** [Td 7d Qc]
Soydemimami: checks
el2254: bets $0.50
Soydemimami: folds
Uncalled bet ($0.50) returned to el2254
el2254 collected $3.09 from pot
el2254: doesn't show hand
*** SUMMARY ***
Total pot $3.25 | Rake $0.16
Board [Td 7d Qc]
Seat 2: el2254 collected ($3.09)
Seat 3: gutacho (button) folded before Flop (didn't bet)
Seat 4: DerFlotti (small blind) folded before Flop
Seat 5: Gatyer14 (big blind) folded before Flop
Seat 6: Soydemimami folded on the Flop


PokerStars Hand #208977513341:  Hold'em No Limit ($0.25/$0.50 USD) - 2020/02/08 12:10:42 ET
Table 'Acamar V' 6-max Seat #4 is the button
Seat 2: el2254 ($37.81 in chips)
Seat 3: gutacho ($47.85 in chips)
Seat 4: DerFlotti ($51.44 in chips)
Seat 5: Gatyer14 ($54.78 in chips)
Seat 6: Soydemimami ($193.30 in chips)
Gatyer14: posts small blind $0.25
Soydemimami: posts big blind $0.50
beerjoe984: sits out
*** HOLE CARDS ***
el2254: calls $0.50
gutacho: folds
DerFlotti: folds
Gatyer14: raises $2 to $2.50
Soydemimami: folds
el2254: folds
Uncalled bet ($2) returned to Gatyer14
Gatyer14 collected $1.50 from pot
Gatyer14: doesn't show hand
*** SUMMARY ***
Total pot $1.50 | Rake $0
Seat 2: el2254 folded before Flop
Seat 3: gutacho folded before Flop (didn't bet)
Seat 4: DerFlotti (button) folded before Flop (didn't bet)
Seat 5: Gatyer14 (small blind) collected ($1.50)
Seat 6: Soydemimami (big blind) folded before Flop


PokerStars Hand #208977527164:  Hold'em No Limit ($0.25/$0.50 USD) - 2020/02/08 12:11:07 ET
Table 'Acamar V' 6-max Seat #5 is the button
Seat 1: beerjoe984 ($50 in chips)
Seat 2: el2254 ($37.31 in chips)
Seat 3: gutacho ($47.85 in chips)
Seat 4: DerFlotti ($51.44 in chips)
Seat 5: Gatyer14 ($55.78 in chips)
Seat 6: Soydemimami ($192.80 in chips)
Soydemimami: posts small blind $0.25
beerjoe984: posts big blind $0.50
*** HOLE CARDS ***
el2254: calls $0.50
gutacho: folds
DerFlotti: folds
Gatyer14: folds
Soydemimami: raises $2 to $2.50
beerjoe984: calls $2
el2254: folds
*** FLOP *** [4c Td Qh]
Soydemimami: bets $2.61
beerjoe984: calls $2.61
*** TURN *** [4c Td Qh] [7c]
Soydemimami: bets $5.09
beerjoe984: folds
Uncalled bet ($5.09) returned to Soydemimami
Soydemimami collected $10.18 from pot
*** SUMMARY ***
Total pot $10.72 | Rake $0.54
Board [4c Td Qh 7c]
Seat 1: beerjoe984 (big blind) folded on the Turn
Seat 2: el2254 folded before Flop
Seat 3: gutacho folded before Flop (didn't bet)
Seat 4: DerFlotti folded before Flop (didn't bet)
Seat 5: Gatyer14 (button) folded before Flop (didn't bet)
Seat 6: Soydemimami (small blind) collected ($10.18)


PokerStars Hand #208977594389:  Hold'em No Limit ($0.25/$0.50 USD) - 2020/02/08 12:13:07 ET
Table 'Acamar V' 6-max Seat #2 is the button
Seat 1: beerjoe984 ($22.53 in chips)
Seat 2: el2254 ($36.06 in chips)
Seat 3: gutacho ($46.85 in chips)
Seat 4: DerFlotti ($73.44 in chips)
Seat 5: Gatyer14 ($55.78 in chips)
Seat 6: Soydemimami ($197.87 in chips)
gutacho: posts small blind $0.25
DerFlotti: posts big blind $0.50
*** HOLE CARDS ***
Gatyer14: folds
Soydemimami: folds
beerjoe984: folds
el2254: raises $0.50 to $1
gutacho: raises $2.50 to $3.50
DerFlotti: folds
el2254: calls $2.50
*** FLOP *** [Jh 2d 3s]
gutacho: bets $7
el2254: folds
Uncalled bet ($7) returned to gutacho
gutacho collected $7.12 from pot
gutacho: doesn't show hand
*** SUMMARY ***
Total pot $7.50 | Rake $0.38
Board [Jh 2d 3s]
Seat 1: beerjoe984 folded before Flop (didn't bet)
Seat 2: el2254 (button) folded on the Flop
Seat 3: gutacho (small blind) collected ($7.12)
Seat 4: DerFlotti (big blind) folded before Flop
Seat 5: Gatyer14 folded before Flop (didn't bet)
Seat 6: Soydemimami folded before Flop (didn't bet)


PokerStars Hand #208977580699:  Hold'em No Limit ($0.25/$0.50 USD) - 2020/02/08 12:12:43 ET
Table 'Acamar V' 6-max Seat #1 is the button
Seat 1: beerjoe984 ($21.39 in chips)
Seat 2: el2254 ($36.31 in chips)
Seat 3: gutacho ($47.85 in chips)
Seat 4: DerFlotti ($73.44 in chips)
Seat 5: Gatyer14 ($55.78 in chips)
Seat 6: Soydemimami ($197.87 in chips)
el2254: posts small blind $0.25
gutacho: posts big blind $0.50
*** HOLE CARDS ***
DerFlotti: folds
Gatyer14: folds
Soydemimami: folds
beerjoe984: raises $0.50 to $1
el2254: folds
gutacho: calls $0.50
*** FLOP *** [Kd Ac Jd]
gutacho: checks
beerjoe984: bets $1
gutacho: folds
Uncalled bet ($1) returned to beerjoe984
beerjoe984 collected $2.14 from pot
beerjoe984: doesn't show hand
*** SUMMARY ***
Total pot $2.25 | Rake $0.11
Board [Kd Ac Jd]
Seat 1: beerjoe984 (button) collected ($2.14)
Seat 2: el2254 (small blind) folded before Flop
Seat 3: gutacho (big blind) folded on the Flop
Seat 4: DerFlotti folded before Flop (didn't bet)
Seat 5: Gatyer14 folded before Flop (didn't bet)
Seat 6: Soydemimami folded before Flop (didn't bet)


PokerStars Hand #208977548399:  Hold'em No Limit ($0.25/$0.50 USD) - 2020/02/08 12:11:45 ET
Table 'Acamar V' 6-max Seat #6 is the button
Seat 1: beerjoe984 ($44.89 in chips)
Seat 2: el2254 ($36.81 in chips)
Seat 3: gutacho ($47.85 in chips)
Seat 4: DerFlotti ($51.44 in chips)
Seat 5: Gatyer14 ($55.78 in chips)
Seat 6: Soydemimami ($197.87 in chips)
beerjoe984: posts small blind $0.25
el2254: posts big blind $0.50
*** HOLE CARDS ***
gutacho: folds
DerFlotti: raises $1 to $1.50
Gatyer14: folds
Soydemimami: folds
beerjoe984: calls $1.25
el2254: folds
*** FLOP *** [Kc 5s Tc]
beerjoe984: bets $1
DerFlotti: raises $3.50 to $4.50
beerjoe984: calls $3.50
*** TURN *** [Kc 5s Tc] [3c]
beerjoe984: bets $6
DerFlotti: calls $6
*** RIVER *** [Kc 5s Tc 3c] [3d]
beerjoe984: bets $11.50
DerFlotti: raises $27.94 to $39.44 and is all-in
beerjoe984: folds
Uncalled bet ($27.94) returned to DerFlotti
DerFlotti collected $45.50 from pot
DerFlotti: doesn't show hand
*** SUMMARY ***
Total pot $47.50 | Rake $2
Board [Kc 5s Tc 3c 3d]
Seat 1: beerjoe984 (small blind) folded on the River
Seat 2: el2254 (big blind) folded before Flop
Seat 3: gutacho folded before Flop (didn't bet)
Seat 4: DerFlotti collected ($45.50)
Seat 5: Gatyer14 folded before Flop (didn't bet)
Seat 6: Soydemimami (button) folded before Flop (didn't bet)


PokerStars Hand #208977620293:  Hold'em No Limit ($0.25/$0.50 USD) - 2020/02/08 12:13:54 ET
Table 'Acamar V' 6-max Seat #4 is the button
Seat 1: beerjoe984 ($22.53 in chips)
Seat 2: el2254 ($32.56 in chips)
Seat 3: gutacho ($50.47 in chips)
Seat 4: DerFlotti ($72.69 in chips)
Seat 5: Gatyer14 ($56.03 in chips)
Seat 6: Soydemimami ($197.87 in chips)
Gatyer14: posts small blind $0.25
Soydemimami: posts big blind $0.50
*** HOLE CARDS ***
beerjoe984: folds
el2254: folds
gutacho: folds
DerFlotti: folds
Gatyer14: folds
Uncalled bet ($0.25) returned to Soydemimami
Soydemimami collected $0.50 from pot
Soydemimami: doesn't show hand
*** SUMMARY ***
Total pot $0.50 | Rake $0
Seat 1: beerjoe984 folded before Flop (didn't bet)
Seat 2: el2254 folded before Flop (didn't bet)
Seat 3: gutacho folded before Flop (didn't bet)
Seat 4: DerFlotti (button) folded before Flop (didn't bet)
Seat 5: Gatyer14 (small blind) folded before Flop
Seat 6: Soydemimami (big blind) collected ($0.50)


PokerStars Hand #208977609563:  Hold'em No Limit ($0.25/$0.50 USD) - 2020/02/08 12:13:35 ET
Table 'Acamar V' 6-max Seat #3 is the button
Seat 1: beerjoe984 ($22.53 in chips)
Seat 2: el2254 ($32.56 in chips)
Seat 3: gutacho ($50.47 in chips)
Seat 4: DerFlotti ($72.94 in chips)
Seat 5: Gatyer14 ($55.78 in chips)
Seat 6: Soydemimami ($197.87 in chips)
DerFlotti: posts small blind $0.25
Gatyer14: posts big blind $0.50
*** HOLE CARDS ***
Soydemimami: folds
beerjoe984: folds
el2254: folds
gutacho: folds
DerFlotti: folds
Uncalled bet ($0.25) returned to Gatyer14
Gatyer14 collected $0.50 from pot
Gatyer14: doesn't show hand
*** SUMMARY ***
Total pot $0.50 | Rake $0
Seat 1: beerjoe984 folded before Flop (didn't bet)
Seat 2: el2254 folded before Flop (didn't bet)
Seat 3: gutacho (button) folded before Flop (didn't bet)
Seat 4: DerFlotti (small blind) folded before Flop
Seat 5: Gatyer14 (big blind) collected ($0.50)
Seat 6: Soydemimami folded before Flop (didn't bet)


PokerStars Hand #208977628760:  Hold'em No Limit ($0.25/$0.50 USD) - 2020/02/08 12:14:09 ET
Table 'Acamar V' 6-max Seat #5 is the button
Seat 1: beerjoe984 ($22.53 in chips)
Seat 2: el2254 ($32.56 in chips)
Seat 3: gutacho ($50.47 in chips)
Seat 4: DerFlotti ($72.69 in chips)
Seat 5: Gatyer14 ($55.78 in chips)
Seat 6: Soydemimami ($198.12 in chips)
Soydemimami: posts small blind $0.25
beerjoe984: posts big blind $0.50
*** HOLE CARDS ***
el2254: calls $0.50
gutacho: folds
gutacho leaves the table
DerFlotti: raises $2 to $2.50
Gatyer14: folds
Soydemimami: folds
beerjoe984: folds
el2254: calls $2
*** FLOP *** [Jh Qh Ad]
el2254: checks
DerFlotti: bets $2.73
el2254: folds
Uncalled bet ($2.73) returned to DerFlotti
DerFlotti collected $5.46 from pot
DerFlotti: doesn't show hand
RM-13rus joins the table at seat #3
*** SUMMARY ***
Total pot $5.75 | Rake $0.29
Board [Jh Qh Ad]
Seat 1: beerjoe984 (big blind) folded before Flop
Seat 2: el2254 folded on the Flop
Seat 3: gutacho folded before Flop (didn't bet)
Seat 4: DerFlotti collected ($5.46)
Seat 5: Gatyer14 (button) folded before Flop (didn't bet)
Seat 6: Soydemimami (small blind) folded before Flop


PokerStars Hand #208977686618:  Hold'em No Limit ($0.25/$0.50 USD) - 2020/02/08 12:15:53 ET
Table 'Acamar V' 6-max Seat #1 is the button
Seat 1: beerjoe984 ($19.03 in chips)
Seat 2: el2254 ($35.61 in chips)
Seat 3: Bula71 ($50 in chips)
Seat 4: DerFlotti ($75.65 in chips)
Seat 5: Gatyer14 ($55.78 in chips)
Seat 6: Soydemimami ($194.87 in chips)
el2254: posts small blind $0.25
Bula71: posts big blind $0.50
*** HOLE CARDS ***
DerFlotti: folds
Gatyer14: folds
Soydemimami: folds
beerjoe984: folds
el2254: folds
Uncalled bet ($0.25) returned to Bula71
Bula71 collected $0.50 from pot
Bula71: doesn't show hand
*** SUMMARY ***
Total pot $0.50 | Rake $0
Seat 1: beerjoe984 (button) folded before Flop (didn't bet)
Seat 2: el2254 (small blind) folded before Flop
Seat 3: Bula71 (big blind) collected ($0.50)
Seat 4: DerFlotti folded before Flop (didn't bet)
Seat 5: Gatyer14 folded before Flop (didn't bet)
Seat 6: Soydemimami folded before Flop (didn't bet)


PokerStars Hand #208977648743:  Hold'em No Limit ($0.25/$0.50 USD) - 2020/02/08 12:14:45 ET
Table 'Acamar V' 6-max Seat #6 is the button
Seat 1: beerjoe984 ($22.03 in chips)
Seat 2: el2254 ($30.06 in chips)
Seat 4: DerFlotti ($75.65 in chips)
Seat 5: Gatyer14 ($55.78 in chips)
Seat 6: Soydemimami ($197.87 in chips)
beerjoe984: posts small blind $0.25
el2254: posts big blind $0.50
*** HOLE CARDS ***
DerFlotti: folds
Gatyer14: folds
Soydemimami: raises $0.50 to $1
RM-13rus leaves the table
beerjoe984: calls $0.75
Bula71 joins the table at seat #3
el2254: calls $0.50
*** FLOP *** [Ks 4c Qd]
beerjoe984: bets $1.50
el2254: calls $1.50
Soydemimami: calls $1.50
*** TURN *** [Ks 4c Qd] [Jh]
beerjoe984: checks
el2254: checks
Soydemimami: checks
*** RIVER *** [Ks 4c Qd Jh] [3d]
beerjoe984: checks
el2254: bets $0.50
Soydemimami: calls $0.50
beerjoe984: calls $0.50
*** SHOW DOWN ***
el2254: shows [3c 3s] (three of a kind, Threes)
Soydemimami: mucks hand
beerjoe984: mucks hand
el2254 collected $8.55 from pot
*** SUMMARY ***
Total pot $9 | Rake $0.45
Board [Ks 4c Qd Jh 3d]
Seat 1: beerjoe984 (small blind) mucked
Seat 2: el2254 (big blind) showed [3c 3s] and won ($8.55) with three of a kind, Threes
Seat 4: DerFlotti folded before Flop (didn't bet)
Seat 5: Gatyer14 folded before Flop (didn't bet)
Seat 6: Soydemimami (button) mucked


PokerStars Hand #208977696517:  Hold'em No Limit ($0.25/$0.50 USD) - 2020/02/08 12:16:11 ET
Table 'Acamar V' 6-max Seat #2 is the button
Seat 1: beerjoe984 ($19.03 in chips)
Seat 2: el2254 ($35.36 in chips)
Seat 3: Bula71 ($50.25 in chips)
Seat 4: DerFlotti ($75.65 in chips)
Seat 5: Gatyer14 ($55.78 in chips)
Seat 6: Soydemimami ($194.87 in chips)
Bula71: posts small blind $0.25
DerFlotti: posts big blind $0.50
*** HOLE CARDS ***
Gatyer14: raises $0.75 to $1.25
Soydemimami: folds
beerjoe984: folds
el2254: folds
Bula71: raises $3.75 to $5
DerFlotti: folds
Gatyer14: calls $3.75
*** FLOP *** [6s 7c 5d]
Bula71: bets $15.25
Gatyer14: raises $35.53 to $50.78 and is all-in
Bula71: folds
Uncalled bet ($35.53) returned to Gatyer14
Gatyer14 collected $39 from pot
Gatyer14: doesn't show hand
*** SUMMARY ***
Total pot $41 | Rake $2
Board [6s 7c 5d]
Seat 1: beerjoe984 folded before Flop (didn't bet)
Seat 2: el2254 (button) folded before Flop (didn't bet)
Seat 3: Bula71 (small blind) folded on the Flop
Seat 4: DerFlotti (big blind) folded before Flop
Seat 5: Gatyer14 collected ($39)
Seat 6: Soydemimami folded before Flop (didn't bet)


PokerStars Hand #208977723018:  Hold'em No Limit ($0.25/$0.50 USD) - 2020/02/08 12:16:58 ET
Table 'Acamar V' 6-max Seat #3 is the button
Seat 1: beerjoe984 ($19.03 in chips)
Seat 2: el2254 ($35.36 in chips)
Seat 3: Bula71 ($50 in chips)
Seat 4: DerFlotti ($75.15 in chips)
Seat 5: Gatyer14 ($74.53 in chips)
Seat 6: Soydemimami ($194.87 in chips)
DerFlotti: posts small blind $0.25
Gatyer14: posts big blind $0.50
*** HOLE CARDS ***
Soydemimami: folds
beerjoe984: raises $0.50 to $1
el2254: folds
Bula71: calls $1
DerFlotti: folds
Gatyer14: calls $0.50
*** FLOP *** [Jd 9c Kh]
Gatyer14: checks
beerjoe984: bets $1.50
Bula71: folds
Gatyer14: folds
Uncalled bet ($1.50) returned to beerjoe984
beerjoe984 collected $3.09 from pot
beerjoe984: doesn't show hand
*** SUMMARY ***
Total pot $3.25 | Rake $0.16
Board [Jd 9c Kh]
Seat 1: beerjoe984 collected ($3.09)
Seat 2: el2254 folded before Flop (didn't bet)
Seat 3: Bula71 (button) folded on the Flop
Seat 4: DerFlotti (small blind) folded before Flop
Seat 5: Gatyer14 (big blind) folded on the Flop
Seat 6: Soydemimami folded before Flop (didn't bet)


PokerStars Hand #208977796462:  Hold'em No Limit ($0.25/$0.50 USD) - 2020/02/08 12:19:11 ET
Table 'Acamar V' 6-max Seat #6 is the button
Seat 1: beerjoe984 ($19.48 in chips)
Seat 2: el2254 ($35.36 in chips)
Seat 3: Bula71 ($50 in chips)
Seat 4: DerFlotti ($74.90 in chips)
Seat 5: Gatyer14 ($72.03 in chips)
Seat 6: Soydemimami ($197.56 in chips)
beerjoe984: posts small blind $0.25
el2254: posts big blind $0.50
*** HOLE CARDS ***
Bula71: folds
DerFlotti: folds
Gatyer14: folds
Soydemimami: folds
beerjoe984: calls $0.25
el2254: checks
*** FLOP *** [6h 5c Ks]
beerjoe984: checks
el2254: checks
*** TURN *** [6h 5c Ks] [Th]
beerjoe984: checks
el2254: checks
*** RIVER *** [6h 5c Ks Th] [Td]
beerjoe984: checks
el2254: checks
*** SHOW DOWN ***
beerjoe984: shows [Jc 3c] (a pair of Tens)
el2254: shows [5h Qd] (two pair, Tens and Fives)
el2254 collected $0.95 from pot
*** SUMMARY ***
Total pot $1 | Rake $0.05
Board [6h 5c Ks Th Td]
Seat 1: beerjoe984 (small blind) showed [Jc 3c] and lost with a pair of Tens
Seat 2: el2254 (big blind) showed [5h Qd] and won ($0.95) with two pair, Tens and Fives
Seat 3: Bula71 folded before Flop (didn't bet)
Seat 4: DerFlotti folded before Flop (didn't bet)
Seat 5: Gatyer14 folded before Flop (didn't bet)
Seat 6: Soydemimami (button) folded before Flop (didn't bet)


PokerStars Hand #208977759572:  Hold'em No Limit ($0.25/$0.50 USD) - 2020/02/08 12:18:04 ET
Table 'Acamar V' 6-max Seat #4 is the button
Seat 1: beerjoe984 ($21.12 in chips)
Seat 2: el2254 ($35.36 in chips)
Seat 3: Bula71 ($50 in chips)
Seat 4: DerFlotti ($74.90 in chips)
Seat 5: Gatyer14 ($73.53 in chips)
Seat 6: Soydemimami ($194.87 in chips)
Gatyer14: posts small blind $0.25
Soydemimami: posts big blind $0.50
*** HOLE CARDS ***
beerjoe984: raises $0.50 to $1
el2254: folds
Bula71: folds
DerFlotti: folds
Gatyer14: folds
Soydemimami: calls $0.50
*** FLOP *** [9h Jh Ah]
Soydemimami: checks
beerjoe984: bets $2
Soydemimami: raises $191.87 to $193.87 and is all-in
beerjoe984: folds
Uncalled bet ($191.87) returned to Soydemimami
Soydemimami collected $5.94 from pot
Soydemimami: doesn't show hand
*** SUMMARY ***
Total pot $6.25 | Rake $0.31
Board [9h Jh Ah]
Seat 1: beerjoe984 folded on the Flop
Seat 2: el2254 folded before Flop (didn't bet)
Seat 3: Bula71 folded before Flop (didn't bet)
Seat 4: DerFlotti (button) folded before Flop (didn't bet)
Seat 5: Gatyer14 (small blind) folded before Flop
Seat 6: Soydemimami (big blind) collected ($5.94)


PokerStars Hand #208977782482:  Hold'em No Limit ($0.25/$0.50 USD) - 2020/02/08 12:18:46 ET
Table 'Acamar V' 6-max Seat #5 is the button
Seat 1: beerjoe984 ($18.12 in chips)
Seat 2: el2254 ($35.36 in chips)
Seat 3: Bula71 ($50 in chips)
Seat 4: DerFlotti ($74.90 in chips)
Seat 5: Gatyer14 ($73.28 in chips)
Seat 6: Soydemimami ($197.81 in chips)
Soydemimami: posts small blind $0.25
beerjoe984: posts big blind $0.50
*** HOLE CARDS ***
el2254: folds
Bula71: folds
DerFlotti: folds
Gatyer14: raises $0.75 to $1.25
Soydemimami: folds
beerjoe984: calls $0.75
*** FLOP *** [Jh Ts 5d]
beerjoe984: bets $1.50
Gatyer14: folds
Uncalled bet ($1.50) returned to beerjoe984
beerjoe984 collected $2.61 from pot
beerjoe984: doesn't show hand
*** SUMMARY ***
Total pot $2.75 | Rake $0.14
Board [Jh Ts 5d]
Seat 1: beerjoe984 (big blind) collected ($2.61)
Seat 2: el2254 folded before Flop (didn't bet)
Seat 3: Bula71 folded before Flop (didn't bet)
Seat 4: DerFlotti folded before Flop (didn't bet)
Seat 5: Gatyer14 (button) folded on the Flop
Seat 6: Soydemimami (small blind) folded before Flop


PokerStars Hand #208977813442:  Hold'em No Limit ($0.25/$0.50 USD) - 2020/02/08 12:19:42 ET
Table 'Acamar V' 6-max Seat #1 is the button
Seat 1: beerjoe984 ($18.98 in chips)
Seat 2: el2254 ($35.81 in chips)
Seat 3: Bula71 ($50 in chips)
Seat 4: DerFlotti ($74.90 in chips)
Seat 5: Gatyer14 ($72.03 in chips)
Seat 6: Soydemimami ($197.56 in chips)
el2254: posts small blind $0.25
Bula71: posts big blind $0.50
*** HOLE CARDS ***
DerFlotti: folds
Gatyer14: folds
Soydemimami: raises $0.75 to $1.25
beerjoe984: calls $1.25
el2254: folds
Bula71: folds
*** FLOP *** [3d Qh 9h]
Soydemimami: checks
beerjoe984: bets $1.50
Soydemimami: calls $1.50
*** TURN *** [3d Qh 9h] [9s]
Soydemimami: checks
beerjoe984: bets $6
Soydemimami: calls $6
*** RIVER *** [3d Qh 9h 9s] [5s]
Soydemimami: checks
beerjoe984: bets $10.23 and is all-in
Soydemimami: calls $10.23
*** SHOW DOWN ***
beerjoe984: shows [Tc Jd] (a pair of Nines)
Soydemimami: shows [Jh Qs] (two pair, Queens and Nines)
Soydemimami collected $36.77 from pot
*** SUMMARY ***
Total pot $38.71 | Rake $1.94
Board [3d Qh 9h 9s 5s]
Seat 1: beerjoe984 (button) showed [Tc Jd] and lost with a pair of Nines
Seat 2: el2254 (small blind) folded before Flop
Seat 3: Bula71 (big blind) folded before Flop
Seat 4: DerFlotti folded before Flop (didn't bet)
Seat 5: Gatyer14 folded before Flop (didn't bet)
Seat 6: Soydemimami showed [Jh Qs] and won ($36.77) with two pair, Queens and Nines


PokerStars Hand #208977841176:  Hold'em No Limit ($0.25/$0.50 USD) - 2020/02/08 12:20:31 ET
Table 'Acamar V' 6-max Seat #2 is the button
Seat 2: el2254 ($35.56 in chips)
Seat 3: Bula71 ($50 in chips)
Seat 4: DerFlotti ($74.90 in chips)
Seat 5: Gatyer14 ($72.03 in chips)
Seat 6: Soydemimami ($215.35 in chips)
Bula71: posts small blind $0.25
DerFlotti: posts big blind $0.50
*** HOLE CARDS ***
Gatyer14: folds
Soydemimami: folds
el2254: folds
Bula71: folds
Uncalled bet ($0.25) returned to DerFlotti
DerFlotti collected $0.50 from pot
DerFlotti: doesn't show hand
*** SUMMARY ***
Total pot $0.50 | Rake $0
Seat 2: el2254 (button) folded before Flop (didn't bet)
Seat 3: Bula71 (small blind) folded before Flop
Seat 4: DerFlotti (big blind) collected ($0.50)
Seat 5: Gatyer14 folded before Flop (didn't bet)
Seat 6: Soydemimami folded before Flop (didn't bet)


PokerStars Hand #208977855154:  Hold'em No Limit ($0.25/$0.50 USD) - 2020/02/08 12:20:57 ET
Table 'Acamar V' 6-max Seat #4 is the button
Seat 1: beerjoe984 ($50 in chips)
Seat 2: el2254 ($35.56 in chips)
Seat 3: Bula71 ($50 in chips)
Seat 4: DerFlotti ($74.90 in chips)
Seat 5: Gatyer14 ($72.28 in chips)
Gatyer14: posts small blind $0.25
Soydemimami: is sitting out
beerjoe984: posts big blind $0.50
*** HOLE CARDS ***
Soydemimami leaves the table
el2254: folds
Bula71: raises $0.75 to $1.25
DerFlotti: folds
Gatyer14: folds
beerjoe984: calls $0.75
*** FLOP *** [4h 9h 2c]
beerjoe984: checks
Bula71: bets $1
beerjoe984: calls $1
*** TURN *** [4h 9h 2c] [6s]
beerjoe984: checks
Bula71: bets $2.50
beerjoe984: calls $2.50
*** RIVER *** [4h 9h 2c 6s] [9s]
beerjoe984: checks
Bula71: bets $7
beerjoe984: calls $7
*** SHOW DOWN ***
Bula71: shows [7h 8h] (a pair of Nines)
beerjoe984: shows [2h 5s] (two pair, Nines and Deuces)
beerjoe984 collected $22.56 from pot
*** SUMMARY ***
Total pot $23.75 | Rake $1.19
Board [4h 9h 2c 6s 9s]
Seat 1: beerjoe984 (big blind) showed [2h 5s] and won ($22.56) with two pair, Nines and Deuces
Seat 2: el2254 folded before Flop (didn't bet)
Seat 3: Bula71 showed [7h 8h] and lost with a pair of Nines
Seat 4: DerFlotti (button) folded before Flop (didn't bet)
Seat 5: Gatyer14 (small blind) folded before Flop


PokerStars Hand #208977849490:  Hold'em No Limit ($0.25/$0.50 USD) - 2020/02/08 12:20:46 ET
Table 'Acamar V' 6-max Seat #3 is the button
Seat 1: beerjoe984 ($50 in chips)
Seat 2: el2254 ($35.56 in chips)
Seat 3: Bula71 ($50 in chips)
Seat 4: DerFlotti ($75.15 in chips)
Seat 5: Gatyer14 ($72.03 in chips)
Seat 6: Soydemimami ($215.35 in chips)
DerFlotti: posts small blind $0.25
Gatyer14: posts big blind $0.50
*** HOLE CARDS ***
Soydemimami: folds
beerjoe984: folds
el2254: folds
Bula71: folds
DerFlotti: folds
Uncalled bet ($0.25) returned to Gatyer14
Gatyer14 collected $0.50 from pot
Gatyer14: doesn't show hand
*** SUMMARY ***
Total pot $0.50 | Rake $0
Seat 1: beerjoe984 folded before Flop (didn't bet)
Seat 2: el2254 folded before Flop (didn't bet)
Seat 3: Bula71 (button) folded before Flop (didn't bet)
Seat 4: DerFlotti (small blind) folded before Flop
Seat 5: Gatyer14 (big blind) collected ($0.50)
Seat 6: Soydemimami folded before Flop (didn't bet)


PokerStars Hand #208977876702:  Hold'em No Limit ($0.25/$0.50 USD) - 2020/02/08 12:21:36 ET
Table 'Acamar V' 6-max Seat #5 is the button
Seat 1: beerjoe984 ($60.81 in chips)
Seat 2: el2254 ($35.56 in chips)
Seat 3: Bula71 ($50 in chips)
Seat 4: DerFlotti ($74.90 in chips)
Seat 5: Gatyer14 ($72.03 in chips)
beerjoe984: posts small blind $0.25
el2254: posts big blind $0.50
*** HOLE CARDS ***
Bula71: raises $0.75 to $1.25
DerFlotti: folds
Gatyer14: folds
beerjoe984: calls $1
el2254: folds
*** FLOP *** [Qc 3d 8h]
beerjoe984: checks
Bula71: checks
*** TURN *** [Qc 3d 8h] [Jc]
beerjoe984: checks
Bula71: checks
*** RIVER *** [Qc 3d 8h Jc] [5s]
beerjoe984: checks
Bula71: checks
*** SHOW DOWN ***
beerjoe984: shows [7s 2s] (high card Queen)
Bula71: shows [As 4s] (high card Ace)
Bula71 collected $2.85 from pot
*** SUMMARY ***
Total pot $3 | Rake $0.15
Board [Qc 3d 8h Jc 5s]
Seat 1: beerjoe984 (small blind) showed [7s 2s] and lost with high card Queen
Seat 2: el2254 (big blind) folded before Flop
Seat 3: Bula71 showed [As 4s] and won ($2.85) with high card Ace
Seat 4: DerFlotti folded before Flop (didn't bet)
Seat 5: Gatyer14 (button) folded before Flop (didn't bet)


PokerStars Hand #208977896801:  Hold'em No Limit ($0.25/$0.50 USD) - 2020/02/08 12:22:12 ET
Table 'Acamar V' 6-max Seat #1 is the button
Seat 1: beerjoe984 ($59.56 in chips)
Seat 2: el2254 ($35.06 in chips)
Seat 3: Bula71 ($51.60 in chips)
Seat 4: DerFlotti ($74.90 in chips)
Seat 5: Gatyer14 ($72.03 in chips)
el2254: posts small blind $0.25
Bula71: posts big blind $0.50
*** HOLE CARDS ***
DerFlotti: folds
Gatyer14: folds
beerjoe984: raises $0.50 to $1
el2254: folds
Bula71: calls $0.50
*** FLOP *** [5d Ks 4d]
Bula71: checks
beerjoe984: bets $1
Bula71: calls $1
*** TURN *** [5d Ks 4d] [Ac]
Bula71: checks
beerjoe984: bets $2
Bula71: calls $2
*** RIVER *** [5d Ks 4d Ac] [8c]
Bula71: checks
beerjoe984: bets $8
Bula71: folds
Uncalled bet ($8) returned to beerjoe984
beerjoe984 collected $7.84 from pot
beerjoe984: doesn't show hand
*** SUMMARY ***
Total pot $8.25 | Rake $0.41
Board [5d Ks 4d Ac 8c]
Seat 1: beerjoe984 (button) collected ($7.84)
Seat 2: el2254 (small blind) folded before Flop
Seat 3: Bula71 (big blind) folded on the River
Seat 4: DerFlotti folded before Flop (didn't bet)
Seat 5: Gatyer14 folded before Flop (didn't bet)


PokerStars Hand #208977921411:  Hold'em No Limit ($0.25/$0.50 USD) - 2020/02/08 12:22:57 ET
Table 'Acamar V' 6-max Seat #2 is the button
Seat 1: beerjoe984 ($63.40 in chips)
Seat 2: el2254 ($34.81 in chips)
Seat 3: Bula71 ($50 in chips)
Seat 4: DerFlotti ($74.90 in chips)
Seat 5: Gatyer14 ($72.03 in chips)
Bula71: posts small blind $0.25
DerFlotti: posts big blind $0.50
*** HOLE CARDS ***
Gatyer14: raises $0.75 to $1.25
beerjoe984: calls $1.25
el2254: folds
Bula71: folds
DerFlotti: calls $0.75
*** FLOP *** [9d 3h 7h]
DerFlotti: checks
NEEMA696 joins the table at seat #6
Gatyer14: checks
beerjoe984: bets $2
DerFlotti: calls $2
Gatyer14: folds
*** TURN *** [9d 3h 7h] [Jh]
DerFlotti: checks
beerjoe984: checks
*** RIVER *** [9d 3h 7h Jh] [3d]
DerFlotti: checks
beerjoe984: checks
*** SHOW DOWN ***
DerFlotti: shows [9c 5s] (two pair, Nines and Threes)
beerjoe984: mucks hand
DerFlotti collected $7.60 from pot
*** SUMMARY ***
Total pot $8 | Rake $0.40
Board [9d 3h 7h Jh 3d]
Seat 1: beerjoe984 mucked
Seat 2: el2254 (button) folded before Flop (didn't bet)
Seat 3: Bula71 (small blind) folded before Flop
Seat 4: DerFlotti (big blind) showed [9c 5s] and won ($7.60) with two pair, Nines and Threes
Seat 5: Gatyer14 folded on the Flop


PokerStars Hand #208977951317:  Hold'em No Limit ($0.25/$0.50 USD) - 2020/02/08 12:23:52 ET
Table 'Acamar V' 6-max Seat #3 is the button
Seat 1: beerjoe984 ($60.15 in chips)
Seat 2: el2254 ($34.81 in chips)
Seat 3: Bula71 ($50 in chips)
Seat 4: DerFlotti ($79.25 in chips)
Seat 6: NEEMA696 ($40 in chips)
DerFlotti: posts small blind $0.25
Gatyer14: is sitting out
NEEMA696: posts big blind $0.50
*** HOLE CARDS ***
beerjoe984: raises $0.50 to $1
el2254: folds
Bula71: folds
Gatyer14 leaves the table
DerFlotti: folds
NEEMA696: folds
Uncalled bet ($0.50) returned to beerjoe984
beerjoe984 collected $1.25 from pot
beerjoe984: doesn't show hand
*** SUMMARY ***
Total pot $1.25 | Rake $0
Seat 1: beerjoe984 collected ($1.25)
Seat 2: el2254 folded before Flop (didn't bet)
Seat 3: Bula71 (button) folded before Flop (didn't bet)
Seat 4: DerFlotti (small blind) folded before Flop
Seat 6: NEEMA696 (big blind) folded before Flop


PokerStars Hand #208977957444:  Hold'em No Limit ($0.25/$0.50 USD) - 2020/02/08 12:24:03 ET
Table 'Acamar V' 6-max Seat #4 is the button
Seat 1: beerjoe984 ($60.90 in chips)
Seat 2: el2254 ($34.81 in chips)
Seat 3: Bula71 ($50 in chips)
Seat 4: DerFlotti ($79 in chips)
Seat 6: NEEMA696 ($39.50 in chips)
NEEMA696: posts small blind $0.25
beerjoe984: posts big blind $0.50
*** HOLE CARDS ***
yzuk joins the table at seat #5
el2254: folds
Bula71: raises $0.75 to $1.25
DerFlotti: folds
NEEMA696: calls $1
beerjoe984: calls $0.75
*** FLOP *** [8c Qh 7d]
NEEMA696: checks
beerjoe984: bets $2
Bula71: folds
NEEMA696: folds
Uncalled bet ($2) returned to beerjoe984
beerjoe984 collected $3.56 from pot
beerjoe984: doesn't show hand
*** SUMMARY ***
Total pot $3.75 | Rake $0.19
Board [8c Qh 7d]
Seat 1: beerjoe984 (big blind) collected ($3.56)
Seat 2: el2254 folded before Flop (didn't bet)
Seat 3: Bula71 folded on the Flop
Seat 4: DerFlotti (button) folded before Flop (didn't bet)
Seat 6: NEEMA696 (small blind) folded on the Flop


PokerStars Hand #208977976897:  Hold'em No Limit ($0.25/$0.50 USD) - 2020/02/08 12:24:39 ET
Table 'Acamar V' 6-max Seat #6 is the button
Seat 1: beerjoe984 ($63.21 in chips)
Seat 2: el2254 ($34.81 in chips)
Seat 3: Bula71 ($50 in chips)
Seat 4: DerFlotti ($79 in chips)
Seat 6: NEEMA696 ($38.25 in chips)
beerjoe984: posts small blind $0.25
el2254: posts big blind $0.50
yzuk: sits out
*** HOLE CARDS ***
Bula71: raises $0.75 to $1.25
DerFlotti: raises $1.75 to $3
NEEMA696: calls $3
beerjoe984: folds
el2254: folds
Bula71: raises $11 to $14
DerFlotti: folds
NEEMA696: folds
Uncalled bet ($11) returned to Bula71
Bula71 collected $9.75 from pot
Bula71: doesn't show hand
*** SUMMARY ***
Total pot $9.75 | Rake $0
Seat 1: beerjoe984 (small blind) folded before Flop
Seat 2: el2254 (big blind) folded before Flop
Seat 3: Bula71 collected ($9.75)
Seat 4: DerFlotti folded before Flop
Seat 6: NEEMA696 (button) folded before Flop


PokerStars Hand #208977994327:  Hold'em No Limit ($0.25/$0.50 USD) - 2020/02/08 12:25:12 ET
Table 'Acamar V' 6-max Seat #1 is the button
Seat 1: beerjoe984 ($62.96 in chips)
Seat 2: el2254 ($34.31 in chips)
Seat 3: Bula71 ($56.75 in chips)
Seat 4: DerFlotti ($76 in chips)
Seat 6: NEEMA696 ($35.25 in chips)
el2254: posts small blind $0.25
Bula71: posts big blind $0.50
yzuk: sits out
*** HOLE CARDS ***
DerFlotti: raises $1 to $1.50
NEEMA696: folds
beerjoe984: folds
NEEMA696 leaves the table
el2254: calls $1.25
Bula71: calls $1
*** FLOP *** [3c Kc 9s]
el2254: bets $3
Bula71: folds
DerFlotti: calls $3
*** TURN *** [3c Kc 9s] [7s]
el2254: bets $3
grandarino joins the table at seat #6
DerFlotti: calls $3
*** RIVER *** [3c Kc 9s 7s] [2s]
el2254: checks
DerFlotti: bets $7.50
el2254: calls $7.50
*** SHOW DOWN ***
DerFlotti: shows [Kd Qh] (a pair of Kings)
el2254: shows [Ks Ad] (a pair of Kings - Ace kicker)
el2254 collected $29.92 from pot
*** SUMMARY ***
Total pot $31.50 | Rake $1.58
Board [3c Kc 9s 7s 2s]
Seat 1: beerjoe984 (button) folded before Flop (didn't bet)
Seat 2: el2254 (small blind) showed [Ks Ad] and won ($29.92) with a pair of Kings
Seat 3: Bula71 (big blind) folded on the Flop
Seat 4: DerFlotti showed [Kd Qh] and lost with a pair of Kings
Seat 6: NEEMA696 folded before Flop (didn't bet)


PokerStars Hand #208978024943:  Hold'em No Limit ($0.25/$0.50 USD) - 2020/02/08 12:26:06 ET
Table 'Acamar V' 6-max Seat #2 is the button
Seat 1: beerjoe984 ($62.96 in chips)
Seat 2: el2254 ($49.23 in chips)
Seat 3: Bula71 ($55.25 in chips)
Seat 4: DerFlotti ($61 in chips)
Bula71: posts small blind $0.25
DerFlotti: posts big blind $0.50
yzuk: sits out
grandarino: sits out
*** HOLE CARDS ***
beerjoe984: calls $0.50
el2254: folds
Bula71: folds
DerFlotti: checks
*** FLOP *** [8d Ts 3h]
DerFlotti: checks
beerjoe984: bets $0.50
DerFlotti: calls $0.50
*** TURN *** [8d Ts 3h] [Ah]
DerFlotti: checks
beerjoe984: bets $1
DerFlotti: calls $1
*** RIVER *** [8d Ts 3h Ah] [6d]
DerFlotti: checks
beerjoe984: checks
*** SHOW DOWN ***
DerFlotti: shows [8s 4d] (a pair of Eights)
beerjoe984: shows [Js Td] (a pair of Tens)
beerjoe984 collected $4.04 from pot
*** SUMMARY ***
Total pot $4.25 | Rake $0.21
Board [8d Ts 3h Ah 6d]
Seat 1: beerjoe984 showed [Js Td] and won ($4.04) with a pair of Tens
Seat 2: el2254 (button) folded before Flop (didn't bet)
Seat 3: Bula71 (small blind) folded before Flop
Seat 4: DerFlotti (big blind) showed [8s 4d] and lost with a pair of Eights


PokerStars Hand #208978052901:  Hold'em No Limit ($0.25/$0.50 USD) - 2020/02/08 12:26:44 ET
Table 'Acamar V' 6-max Seat #3 is the button
Seat 1: beerjoe984 ($65 in chips)
Seat 2: el2254 ($49.23 in chips)
Seat 3: Bula71 ($55 in chips)
Seat 4: DerFlotti ($59 in chips)
Seat 5: yzuk ($50 in chips)
DerFlotti: posts small blind $0.25
yzuk: posts big blind $0.50
grandarino: sits out
*** HOLE CARDS ***
beerjoe984: folds
el2254: folds
Bula71: folds
DerFlotti: raises $0.50 to $1
yzuk: raises $3.50 to $4.50
DerFlotti: folds
Uncalled bet ($3.50) returned to yzuk
yzuk collected $2 from pot
yzuk: doesn't show hand
*** SUMMARY ***
Total pot $2 | Rake $0
Seat 1: beerjoe984 folded before Flop (didn't bet)
Seat 2: el2254 folded before Flop (didn't bet)
Seat 3: Bula71 (button) folded before Flop (didn't bet)
Seat 4: DerFlotti (small blind) folded before Flop
Seat 5: yzuk (big blind) collected ($2)


PokerStars Hand #208978065870:  Hold'em No Limit ($0.25/$0.50 USD) - 2020/02/08 12:27:07 ET
Table 'Acamar V' 6-max Seat #4 is the button
Seat 1: beerjoe984 ($65 in chips)
Seat 2: el2254 ($49.23 in chips)
Seat 3: Bula71 ($55 in chips)
Seat 4: DerFlotti ($58 in chips)
Seat 5: yzuk ($51 in chips)
Seat 6: grandarino ($50 in chips)
yzuk: posts small blind $0.25
grandarino: posts big blind $0.50
*** HOLE CARDS ***
beerjoe984: raises $0.50 to $1
el2254: folds
Bula71: folds
DerFlotti: folds
yzuk: folds
grandarino: calls $0.50
*** FLOP *** [6c 4h 3d]
grandarino: checks
beerjoe984: bets $1
grandarino: calls $1
*** TURN *** [6c 4h 3d] [Td]
grandarino: checks
beerjoe984: bets $2
grandarino: folds
Uncalled bet ($2) returned to beerjoe984
el2254 leaves the table
beerjoe984 collected $4.04 from pot
beerjoe984: doesn't show hand
*** SUMMARY ***
Total pot $4.25 | Rake $0.21
Board [6c 4h 3d Td]
Seat 1: beerjoe984 collected ($4.04)
Seat 2: el2254 folded before Flop (didn't bet)
Seat 3: Bula71 folded before Flop (didn't bet)
Seat 4: DerFlotti (button) folded before Flop (didn't bet)
Seat 5: yzuk (small blind) folded before Flop
Seat 6: grandarino (big blind) folded on the Turn


PokerStars Hand #208978084134:  Hold'em No Limit ($0.25/$0.50 USD) - 2020/02/08 12:27:39 ET
Table 'Acamar V' 6-max Seat #5 is the button
Seat 1: beerjoe984 ($67.04 in chips)
Seat 3: Bula71 ($55 in chips)
Seat 4: DerFlotti ($58 in chips)
Seat 5: yzuk ($50.75 in chips)
Seat 6: grandarino ($50 in chips)
grandarino: posts small blind $0.25
beerjoe984: posts big blind $0.50
*** HOLE CARDS ***
Bula71: folds
DerFlotti: folds
yzuk: folds
grandarino: folds
Uncalled bet ($0.25) returned to beerjoe984
beerjoe984 collected $0.50 from pot
beerjoe984: doesn't show hand
*** SUMMARY ***
Total pot $0.50 | Rake $0
Seat 1: beerjoe984 (big blind) collected ($0.50)
Seat 3: Bula71 folded before Flop (didn't bet)
Seat 4: DerFlotti folded before Flop (didn't bet)
Seat 5: yzuk (button) folded before Flop (didn't bet)
Seat 6: grandarino (small blind) folded before Flop


PokerStars Hand #208978091256:  Hold'em No Limit ($0.25/$0.50 USD) - 2020/02/08 12:27:52 ET
Table 'Acamar V' 6-max Seat #6 is the button
Seat 1: beerjoe984 ($67.29 in chips)
Seat 3: Bula71 ($55 in chips)
Seat 4: DerFlotti ($58 in chips)
Seat 5: yzuk ($50.75 in chips)
Seat 6: grandarino ($50 in chips)
gitarist74 joins the table at seat #2
beerjoe984: posts small blind $0.25
Bula71: posts big blind $0.50
*** HOLE CARDS ***
DerFlotti: folds
yzuk: folds
grandarino: folds
beerjoe984: raises $0.50 to $1
Bula71: folds
Uncalled bet ($0.50) returned to beerjoe984
beerjoe984 collected $1 from pot
beerjoe984: doesn't show hand
*** SUMMARY ***
Total pot $1 | Rake $0
Seat 1: beerjoe984 (small blind) collected ($1)
Seat 3: Bula71 (big blind) folded before Flop
Seat 4: DerFlotti folded before Flop (didn't bet)
Seat 5: yzuk folded before Flop (didn't bet)
Seat 6: grandarino (button) folded before Flop (didn't bet)


PokerStars Hand #208978125884:  Hold'em No Limit ($0.25/$0.50 USD) - 2020/02/08 12:28:53 ET
Table 'Acamar V' 6-max Seat #3 is the button
Seat 1: beerjoe984 ($67.79 in chips)
Seat 3: Bula71 ($54.25 in chips)
Seat 4: DerFlotti ($38.23 in chips)
Seat 5: yzuk ($50.75 in chips)
Seat 6: grandarino ($68.03 in chips)
DerFlotti: posts small blind $0.25
yzuk: posts big blind $0.50
gitarist74: sits out
*** HOLE CARDS ***
grandarino: folds
beerjoe984: folds
Bula71: folds
DerFlotti: folds
Uncalled bet ($0.25) returned to yzuk
yzuk collected $0.50 from pot
yzuk: doesn't show hand
*** SUMMARY ***
Total pot $0.50 | Rake $0
Seat 1: beerjoe984 folded before Flop (didn't bet)
Seat 3: Bula71 (button) folded before Flop (didn't bet)
Seat 4: DerFlotti (small blind) folded before Flop
Seat 5: yzuk (big blind) collected ($0.50)
Seat 6: grandarino folded before Flop (didn't bet)


PokerStars Hand #208978131352:  Hold'em No Limit ($0.25/$0.50 USD) - 2020/02/08 12:29:03 ET
Table 'Acamar V' 6-max Seat #4 is the button
Seat 1: beerjoe984 ($67.79 in chips)
Seat 3: Bula71 ($54.25 in chips)
Seat 4: DerFlotti ($37.98 in chips)
Seat 5: yzuk ($51 in chips)
Seat 6: grandarino ($68.03 in chips)
yzuk: posts small blind $0.25
grandarino: posts big blind $0.50
gitarist74: sits out
*** HOLE CARDS ***
beerjoe984: raises $0.50 to $1
Bula71: folds
DerFlotti: folds
yzuk: folds
grandarino: folds
Uncalled bet ($0.50) returned to beerjoe984
beerjoe984 collected $1.25 from pot
beerjoe984: doesn't show hand
*** SUMMARY ***
Total pot $1.25 | Rake $0
Seat 1: beerjoe984 collected ($1.25)
Seat 3: Bula71 folded before Flop (didn't bet)
Seat 4: DerFlotti (button) folded before Flop (didn't bet)
Seat 5: yzuk (small blind) folded before Flop
Seat 6: grandarino (big blind) folded before Flop


PokerStars Hand #208978098377:  Hold'em No Limit ($0.25/$0.50 USD) - 2020/02/08 12:28:05 ET
Table 'Acamar V' 6-max Seat #1 is the button
Seat 1: beerjoe984 ($67.79 in chips)
Seat 3: Bula71 ($54.50 in chips)
Seat 4: DerFlotti ($58 in chips)
Seat 5: yzuk ($50.75 in chips)
Seat 6: grandarino ($50 in chips)
Bula71: posts small blind $0.25
DerFlotti: posts big blind $0.50
*** HOLE CARDS ***
yzuk: folds
grandarino: raises $0.60 to $1.10
beerjoe984: folds
Bula71: folds
DerFlotti: calls $0.60
*** FLOP *** [7d 9s 7c]
DerFlotti: checks
grandarino: checks
*** TURN *** [7d 9s 7c] [6h]
DerFlotti: bets $1.17
grandarino: calls $1.17
*** RIVER *** [7d 9s 7c 6h] [Qh]
DerFlotti: bets $3.50
grandarino: raises $14 to $17.50
DerFlotti: calls $14
*** SHOW DOWN ***
grandarino: shows [9c 9d] (a full house, Nines full of Sevens)
DerFlotti: mucks hand
grandarino collected $37.80 from pot
*** SUMMARY ***
Total pot $39.79 | Rake $1.99
Board [7d 9s 7c 6h Qh]
Seat 1: beerjoe984 (button) folded before Flop (didn't bet)
Seat 3: Bula71 (small blind) folded before Flop
Seat 4: DerFlotti (big blind) mucked
Seat 5: yzuk folded before Flop (didn't bet)
Seat 6: grandarino showed [9c 9d] and won ($37.80) with a full house, Nines full of Sevens


PokerStars Hand #208978138418:  Hold'em No Limit ($0.25/$0.50 USD) - 2020/02/08 12:29:15 ET
Table 'Acamar V' 6-max Seat #5 is the button
Seat 1: beerjoe984 ($68.54 in chips)
Seat 3: Bula71 ($54.25 in chips)
Seat 4: DerFlotti ($37.98 in chips)
Seat 5: yzuk ($50.75 in chips)
Seat 6: grandarino ($67.53 in chips)
grandarino: posts small blind $0.25
beerjoe984: posts big blind $0.50
gitarist74: sits out
*** HOLE CARDS ***
Bula71: folds
DerFlotti: folds
yzuk: raises $0.55 to $1.05
grandarino: folds
beerjoe984: calls $0.55
*** FLOP *** [4h 6d Jh]
beerjoe984: checks
yzuk: bets $0.89
beerjoe984: calls $0.89
*** TURN *** [4h 6d Jh] [Qh]
beerjoe984: checks
yzuk: bets $1.29
beerjoe984: calls $1.29
*** RIVER *** [4h 6d Jh Qh] [3h]
beerjoe984: checks
yzuk: checks
*** SHOW DOWN ***
beerjoe984: shows [3d 4s] (two pair, Fours and Threes)
yzuk: mucks hand
beerjoe984 collected $6.37 from pot
*** SUMMARY ***
Total pot $6.71 | Rake $0.34
Board [4h 6d Jh Qh 3h]
Seat 1: beerjoe984 (big blind) showed [3d 4s] and won ($6.37) with two pair, Fours and Threes
Seat 3: Bula71 folded before Flop (didn't bet)
Seat 4: DerFlotti folded before Flop (didn't bet)
Seat 5: yzuk (button) mucked
Seat 6: grandarino (small blind) folded before Flop


PokerStars Hand #208978162233:  Hold'em No Limit ($0.25/$0.50 USD) - 2020/02/08 12:29:57 ET
Table 'Acamar V' 6-max Seat #6 is the button
Seat 1: beerjoe984 ($71.68 in chips)
Seat 2: gitarist74 ($50 in chips)
Seat 3: Bula71 ($54.25 in chips)
Seat 4: DerFlotti ($37.98 in chips)
Seat 5: yzuk ($50 in chips)
Seat 6: grandarino ($67.28 in chips)
beerjoe984: posts small blind $0.25
gitarist74: posts big blind $0.50
*** HOLE CARDS ***
Bula71: folds
DerFlotti: folds
yzuk: folds
grandarino: raises $0.60 to $1.10
beerjoe984: folds
gitarist74: folds
Uncalled bet ($0.60) returned to grandarino
grandarino collected $1.25 from pot
grandarino: doesn't show hand
*** SUMMARY ***
Total pot $1.25 | Rake $0
Seat 1: beerjoe984 (small blind) folded before Flop
Seat 2: gitarist74 (big blind) folded before Flop
Seat 3: Bula71 folded before Flop (didn't bet)
Seat 4: DerFlotti folded before Flop (didn't bet)
Seat 5: yzuk folded before Flop (didn't bet)
Seat 6: grandarino (button) collected ($1.25)


PokerStars Hand #208978169181:  Hold'em No Limit ($0.25/$0.50 USD) - 2020/02/08 12:30:10 ET
Table 'Acamar V' 6-max Seat #1 is the button
Seat 1: beerjoe984 ($71.43 in chips)
Seat 2: gitarist74 ($50 in chips)
Seat 3: Bula71 ($54.25 in chips)
Seat 4: DerFlotti ($37.98 in chips)
Seat 5: yzuk ($50 in chips)
Seat 6: grandarino ($68.03 in chips)
gitarist74: posts small blind $0.25
Bula71: posts big blind $0.50
*** HOLE CARDS ***
DerFlotti: folds
yzuk: folds
grandarino: folds
beerjoe984: folds
gitarist74: folds
Uncalled bet ($0.25) returned to Bula71
Bula71 collected $0.50 from pot
Bula71: doesn't show hand
*** SUMMARY ***
Total pot $0.50 | Rake $0
Seat 1: beerjoe984 (button) folded before Flop (didn't bet)
Seat 2: gitarist74 (small blind) folded before Flop
Seat 3: Bula71 (big blind) collected ($0.50)
Seat 4: DerFlotti folded before Flop (didn't bet)
Seat 5: yzuk folded before Flop (didn't bet)
Seat 6: grandarino folded before Flop (didn't bet)


PokerStars Hand #208978175020:  Hold'em No Limit ($0.25/$0.50 USD) - 2020/02/08 12:30:19 ET
Table 'Acamar V' 6-max Seat #2 is the button
Seat 1: beerjoe984 ($71.43 in chips)
Seat 2: gitarist74 ($50 in chips)
Seat 3: Bula71 ($54.50 in chips)
Seat 4: DerFlotti ($37.98 in chips)
Seat 5: yzuk ($50 in chips)
Seat 6: grandarino ($68.03 in chips)
Bula71: posts small blind $0.25
DerFlotti: posts big blind $0.50
*** HOLE CARDS ***
yzuk: folds
grandarino: folds
beerjoe984: folds
gitarist74: raises $0.75 to $1.25
Bula71: folds
DerFlotti: calls $0.75
*** FLOP *** [2h 8c 6s]
DerFlotti: checks
gitarist74: bets $1.30
DerFlotti: folds
Uncalled bet ($1.30) returned to gitarist74
gitarist74 collected $2.61 from pot
*** SUMMARY ***
Total pot $2.75 | Rake $0.14
Board [2h 8c 6s]
Seat 1: beerjoe984 folded before Flop (didn't bet)
Seat 2: gitarist74 (button) collected ($2.61)
Seat 3: Bula71 (small blind) folded before Flop
Seat 4: DerFlotti (big blind) folded on the Flop
Seat 5: yzuk folded before Flop (didn't bet)
Seat 6: grandarino folded before Flop (didn't bet)


PokerStars Hand #208978199618:  Hold'em No Limit ($0.25/$0.50 USD) - 2020/02/08 12:31:02 ET
Table 'Acamar V' 6-max Seat #3 is the button
Seat 1: beerjoe984 ($71.43 in chips)
Seat 2: gitarist74 ($51.36 in chips)
Seat 3: Bula71 ($54.25 in chips)
Seat 4: DerFlotti ($36.73 in chips)
Seat 5: yzuk ($50 in chips)
Seat 6: grandarino ($68.03 in chips)
DerFlotti: posts small blind $0.25
yzuk: posts big blind $0.50
*** HOLE CARDS ***
grandarino: folds
beerjoe984: raises $0.50 to $1
gitarist74: folds
Bula71: raises $2.50 to $3.50
DerFlotti: folds
yzuk: folds
beerjoe984: calls $2.50
*** FLOP *** [5h 8d Kd]
beerjoe984: bets $3.50
Bula71: calls $3.50
*** TURN *** [5h 8d Kd] [Qh]
beerjoe984: bets $7
Bula71: calls $7
*** RIVER *** [5h 8d Kd Qh] [4d]
beerjoe984: bets $13.50
Bula71: folds
Uncalled bet ($13.50) returned to beerjoe984
beerjoe984 collected $27.31 from pot
beerjoe984: doesn't show hand
*** SUMMARY ***
Total pot $28.75 | Rake $1.44
Board [5h 8d Kd Qh 4d]
Seat 1: beerjoe984 collected ($27.31)
Seat 2: gitarist74 folded before Flop (didn't bet)
Seat 3: Bula71 (button) folded on the River
Seat 4: DerFlotti (small blind) folded before Flop
Seat 5: yzuk (big blind) folded before Flop
Seat 6: grandarino folded before Flop (didn't bet)


PokerStars Hand #208978270636:  Hold'em No Limit ($0.25/$0.50 USD) - 2020/02/08 12:33:07 ET
Table 'Acamar V' 6-max Seat #5 is the button
Seat 1: beerjoe984 ($63.10 in chips)
Seat 2: gitarist74 ($51.36 in chips)
Seat 3: Bula71 ($50 in chips)
Seat 4: DerFlotti ($36.48 in chips)
Seat 5: yzuk ($50 in chips)
Seat 6: grandarino ($87.92 in chips)
grandarino: posts small blind $0.25
beerjoe984: posts big blind $0.50
*** HOLE CARDS ***
gitarist74: folds
Bula71: folds
DerFlotti: folds
yzuk: raises $0.55 to $1.05
grandarino: raises $0.70 to $1.75
beerjoe984: calls $1.25
yzuk: raises $6.25 to $8
grandarino: folds
beerjoe984: folds
Uncalled bet ($6.25) returned to yzuk
yzuk collected $5.25 from pot
yzuk: doesn't show hand
*** SUMMARY ***
Total pot $5.25 | Rake $0
Seat 1: beerjoe984 (big blind) folded before Flop
Seat 2: gitarist74 folded before Flop (didn't bet)
Seat 3: Bula71 folded before Flop (didn't bet)
Seat 4: DerFlotti folded before Flop (didn't bet)
Seat 5: yzuk (button) collected ($5.25)
Seat 6: grandarino (small blind) folded before Flop


PokerStars Hand #208978243799:  Hold'em No Limit ($0.25/$0.50 USD) - 2020/02/08 12:32:20 ET
Table 'Acamar V' 6-max Seat #4 is the button
Seat 1: beerjoe984 ($84.74 in chips)
Seat 2: gitarist74 ($51.36 in chips)
Seat 3: Bula71 ($50 in chips)
Seat 4: DerFlotti ($36.48 in chips)
Seat 5: yzuk ($50 in chips)
Seat 6: grandarino ($68.03 in chips)
yzuk: posts small blind $0.25
grandarino: posts big blind $0.50
*** HOLE CARDS ***
beerjoe984: raises $0.50 to $1
gitarist74: folds
Bula71: folds
DerFlotti: folds
yzuk: folds
grandarino: calls $0.50
*** FLOP *** [5c 9s 8d]
grandarino: checks
beerjoe984: bets $1
grandarino: calls $1
*** TURN *** [5c 9s 8d] [Ah]
grandarino: checks
beerjoe984: bets $2
grandarino: raises $5 to $7
beerjoe984: calls $5
*** RIVER *** [5c 9s 8d Ah] [Qc]
grandarino: bets $12.64
beerjoe984: calls $12.64
*** SHOW DOWN ***
grandarino: shows [Ac 8s] (two pair, Aces and Eights)
beerjoe984: mucks hand
grandarino collected $41.53 from pot
*** SUMMARY ***
Total pot $43.53 | Rake $2
Board [5c 9s 8d Ah Qc]
Seat 1: beerjoe984 mucked
Seat 2: gitarist74 folded before Flop (didn't bet)
Seat 3: Bula71 folded before Flop (didn't bet)
Seat 4: DerFlotti (button) folded before Flop (didn't bet)
Seat 5: yzuk (small blind) folded before Flop
Seat 6: grandarino (big blind) showed [Ac 8s] and won ($41.53) with two pair, Aces and Eights


PokerStars Hand #208978284485:  Hold'em No Limit ($0.25/$0.50 USD) - 2020/02/08 12:33:31 ET
Table 'Acamar V' 6-max Seat #6 is the button
Seat 1: beerjoe984 ($61.35 in chips)
Seat 2: gitarist74 ($51.36 in chips)
Seat 3: Bula71 ($50 in chips)
Seat 4: DerFlotti ($36.48 in chips)
Seat 5: yzuk ($53.50 in chips)
Seat 6: grandarino ($86.17 in chips)
beerjoe984: posts small blind $0.25
gitarist74: posts big blind $0.50
*** HOLE CARDS ***
Bula71: folds
DerFlotti: folds
DerFlotti leaves the table
yzuk: folds
grandarino: folds
beerjoe984: raises $0.50 to $1
gitarist74: calls $0.50
*** FLOP *** [8d Ah 3c]
beerjoe984: bets $1
gitarist74: calls $1
*** TURN *** [8d Ah 3c] [5d]
reginaph joins the table at seat #4
beerjoe984: bets $2
gitarist74: raises $6.63 to $8.63
beerjoe984: calls $6.63
*** RIVER *** [8d Ah 3c 5d] [4d]
beerjoe984: bets $10
gitarist74: calls $10
*** SHOW DOWN ***
beerjoe984: shows [Kh 2s] (a straight, Ace to Five)
gitarist74: mucks hand
beerjoe984 collected $39.26 from pot
*** SUMMARY ***
Total pot $41.26 | Rake $2
Board [8d Ah 3c 5d 4d]
Seat 1: beerjoe984 (small blind) showed [Kh 2s] and won ($39.26) with a straight, Ace to Five
Seat 2: gitarist74 (big blind) mucked
Seat 3: Bula71 folded before Flop (didn't bet)
Seat 4: DerFlotti folded before Flop (didn't bet)
Seat 5: yzuk folded before Flop (didn't bet)
Seat 6: grandarino (button) folded before Flop (didn't bet)


PokerStars Hand #208978341210:  Hold'em No Limit ($0.25/$0.50 USD) - 2020/02/08 12:35:10 ET
Table 'Acamar V' 6-max Seat #3 is the button
Seat 1: beerjoe984 ($80.73 in chips)
Seat 2: gitarist74 ($50 in chips)
Seat 3: Bula71 ($50.50 in chips)
Seat 4: reginaph ($50 in chips)
Seat 5: yzuk ($53.50 in chips)
Seat 6: grandarino ($86.17 in chips)
reginaph: posts small blind $0.25
yzuk: posts big blind $0.50
*** HOLE CARDS ***
grandarino: raises $1 to $1.50
beerjoe984: folds
gitarist74: folds
Bula71: folds
reginaph: folds
yzuk: folds
Uncalled bet ($1) returned to grandarino
grandarino collected $1.25 from pot
grandarino: doesn't show hand
*** SUMMARY ***
Total pot $1.25 | Rake $0
Seat 1: beerjoe984 folded before Flop (didn't bet)
Seat 2: gitarist74 folded before Flop (didn't bet)
Seat 3: Bula71 (button) folded before Flop (didn't bet)
Seat 4: reginaph (small blind) folded before Flop
Seat 5: yzuk (big blind) folded before Flop
Seat 6: grandarino collected ($1.25)


PokerStars Hand #208978321791:  Hold'em No Limit ($0.25/$0.50 USD) - 2020/02/08 12:34:36 ET
Table 'Acamar V' 6-max Seat #1 is the button
Seat 1: beerjoe984 ($79.98 in chips)
Seat 2: gitarist74 ($50 in chips)
Seat 3: Bula71 ($50 in chips)
Seat 5: yzuk ($53.50 in chips)
Seat 6: grandarino ($86.17 in chips)
gitarist74: posts small blind $0.25
Bula71: posts big blind $0.50
reginaph: sits out
*** HOLE CARDS ***
yzuk: folds
grandarino: folds
beerjoe984: raises $0.50 to $1
gitarist74: folds
Bula71: folds
Uncalled bet ($0.50) returned to beerjoe984
beerjoe984 collected $1.25 from pot
beerjoe984: doesn't show hand
*** SUMMARY ***
Total pot $1.25 | Rake $0
Seat 1: beerjoe984 (button) collected ($1.25)
Seat 2: gitarist74 (small blind) folded before Flop
Seat 3: Bula71 (big blind) folded before Flop
Seat 5: yzuk folded before Flop (didn't bet)
Seat 6: grandarino folded before Flop (didn't bet)


PokerStars Hand #208978330851:  Hold'em No Limit ($0.25/$0.50 USD) - 2020/02/08 12:34:52 ET
Table 'Acamar V' 6-max Seat #2 is the button
Seat 1: beerjoe984 ($80.73 in chips)
Seat 2: gitarist74 ($50 in chips)
Seat 3: Bula71 ($50 in chips)
Seat 4: reginaph ($50 in chips)
Seat 5: yzuk ($53.50 in chips)
Seat 6: grandarino ($86.17 in chips)
Bula71: posts small blind $0.25
reginaph: posts big blind $0.50
*** HOLE CARDS ***
yzuk: folds
grandarino: folds
beerjoe984: folds
gitarist74: folds
Bula71: raises $0.75 to $1.25
reginaph: folds
Uncalled bet ($0.75) returned to Bula71
Bula71 collected $1 from pot
Bula71: doesn't show hand
*** SUMMARY ***
Total pot $1 | Rake $0
Seat 1: beerjoe984 folded before Flop (didn't bet)
Seat 2: gitarist74 (button) folded before Flop (didn't bet)
Seat 3: Bula71 (small blind) collected ($1)
Seat 4: reginaph (big blind) folded before Flop
Seat 5: yzuk folded before Flop (didn't bet)
Seat 6: grandarino folded before Flop (didn't bet)


PokerStars Hand #208978371530:  Hold'em No Limit ($0.25/$0.50 USD) - 2020/02/08 12:36:03 ET
Table 'Acamar V' 6-max Seat #5 is the button
Seat 1: beerjoe984 ($80.73 in chips)
Seat 2: gitarist74 ($50 in chips)
Seat 3: Bula71 ($50.50 in chips)
Seat 4: reginaph ($50 in chips)
Seat 5: yzuk ($52.75 in chips)
Seat 6: grandarino ($87.17 in chips)
grandarino: posts small blind $0.25
beerjoe984: posts big blind $0.50
*** HOLE CARDS ***
gitarist74: raises $0.90 to $1.40
Bula71: folds
reginaph: folds
yzuk: folds
grandarino: calls $1.15
beerjoe984: folds
*** FLOP *** [5h Th As]
grandarino: checks
gitarist74: bets $1.57
grandarino: folds
Uncalled bet ($1.57) returned to gitarist74
gitarist74 collected $3.14 from pot
*** SUMMARY ***
Total pot $3.30 | Rake $0.16
Board [5h Th As]
Seat 1: beerjoe984 (big blind) folded before Flop
Seat 2: gitarist74 collected ($3.14)
Seat 3: Bula71 folded before Flop (didn't bet)
Seat 4: reginaph folded before Flop (didn't bet)
Seat 5: yzuk (button) folded before Flop (didn't bet)
Seat 6: grandarino (small blind) folded on the Flop


PokerStars Hand #208978356534:  Hold'em No Limit ($0.25/$0.50 USD) - 2020/02/08 12:35:36 ET
Table 'Acamar V' 6-max Seat #4 is the button
Seat 1: beerjoe984 ($80.73 in chips)
Seat 2: gitarist74 ($50 in chips)
Seat 3: Bula71 ($50.50 in chips)
Seat 4: reginaph ($50 in chips)
Seat 5: yzuk ($53 in chips)
Seat 6: grandarino ($86.92 in chips)
yzuk: posts small blind $0.25
grandarino: posts big blind $0.50
*** HOLE CARDS ***
beerjoe984: folds
gitarist74: folds
Bula71: folds
reginaph: folds
yzuk: folds
Uncalled bet ($0.25) returned to grandarino
grandarino collected $0.50 from pot
grandarino: doesn't show hand
*** SUMMARY ***
Total pot $0.50 | Rake $0
Seat 1: beerjoe984 folded before Flop (didn't bet)
Seat 2: gitarist74 folded before Flop (didn't bet)
Seat 3: Bula71 folded before Flop (didn't bet)
Seat 4: reginaph (button) folded before Flop (didn't bet)
Seat 5: yzuk (small blind) folded before Flop
Seat 6: grandarino (big blind) collected ($0.50)


PokerStars Hand #208978388868:  Hold'em No Limit ($0.25/$0.50 USD) - 2020/02/08 12:36:33 ET
Table 'Acamar V' 6-max Seat #6 is the button
Seat 1: beerjoe984 ($80.23 in chips)
Seat 2: gitarist74 ($51.74 in chips)
Seat 3: Bula71 ($50.50 in chips)
Seat 4: reginaph ($50 in chips)
Seat 5: yzuk ($52.75 in chips)
Seat 6: grandarino ($85.77 in chips)
beerjoe984: posts small blind $0.25
gitarist74: posts big blind $0.50
*** HOLE CARDS ***
Bula71: folds
reginaph: folds
yzuk: folds
grandarino: raises $0.60 to $1.10
beerjoe984: calls $0.85
gitarist74: calls $0.60
*** FLOP *** [8d 2c 5d]
beerjoe984: checks
gitarist74: checks
grandarino: bets $1.25
beerjoe984: calls $1.25
gitarist74: folds
*** TURN *** [8d 2c 5d] [6d]
beerjoe984: bets $3
grandarino: calls $3
*** RIVER *** [8d 2c 5d 6d] [6h]
beerjoe984: bets $5.50
grandarino: folds
Uncalled bet ($5.50) returned to beerjoe984
beerjoe984 collected $11.21 from pot
beerjoe984: doesn't show hand
*** SUMMARY ***
Total pot $11.80 | Rake $0.59
Board [8d 2c 5d 6d 6h]
Seat 1: beerjoe984 (small blind) collected ($11.21)
Seat 2: gitarist74 (big blind) folded on the Flop
Seat 3: Bula71 folded before Flop (didn't bet)
Seat 4: reginaph folded before Flop (didn't bet)
Seat 5: yzuk folded before Flop (didn't bet)
Seat 6: grandarino (button) folded on the River


PokerStars Hand #208978426128:  Hold'em No Limit ($0.25/$0.50 USD) - 2020/02/08 12:37:38 ET
Table 'Acamar V' 6-max Seat #1 is the button
Seat 1: beerjoe984 ($86.09 in chips)
Seat 2: gitarist74 ($50.64 in chips)
Seat 3: Bula71 ($50.50 in chips)
Seat 4: reginaph ($50 in chips)
Seat 5: yzuk ($52.75 in chips)
Seat 6: grandarino ($80.42 in chips)
gitarist74: posts small blind $0.25
Bula71: posts big blind $0.50
*** HOLE CARDS ***
reginaph: raises $0.75 to $1.25
yzuk: calls $1.25
grandarino: folds
beerjoe984: folds
gitarist74: folds
Bula71: folds
*** FLOP *** [5d Jc 8d]
reginaph: checks
yzuk: bets $2.04
reginaph: folds
Uncalled bet ($2.04) returned to yzuk
yzuk collected $3.09 from pot
yzuk: doesn't show hand
*** SUMMARY ***
Total pot $3.25 | Rake $0.16
Board [5d Jc 8d]
Seat 1: beerjoe984 (button) folded before Flop (didn't bet)
Seat 2: gitarist74 (small blind) folded before Flop
Seat 3: Bula71 (big blind) folded before Flop
Seat 4: reginaph folded on the Flop
Seat 5: yzuk collected ($3.09)
Seat 6: grandarino folded before Flop (didn't bet)


PokerStars Hand #208978476367:  Hold'em No Limit ($0.25/$0.50 USD) - 2020/02/08 12:39:07 ET
Table 'Acamar V' 6-max Seat #3 is the button
Seat 1: beerjoe984 ($84.84 in chips)
Seat 2: gitarist74 ($50.39 in chips)
Seat 3: Bula71 ($50 in chips)
Seat 4: reginaph ($50 in chips)
Seat 5: yzuk ($54.59 in chips)
Seat 6: grandarino ($82.97 in chips)
reginaph: posts small blind $0.25
yzuk: posts big blind $0.50
*** HOLE CARDS ***
grandarino: raises $1 to $1.50
beerjoe984: folds
gitarist74: folds
Bula71: folds
reginaph: folds
yzuk: folds
Uncalled bet ($1) returned to grandarino
grandarino collected $1.25 from pot
grandarino: doesn't show hand
*** SUMMARY ***
Total pot $1.25 | Rake $0
Seat 1: beerjoe984 folded before Flop (didn't bet)
Seat 2: gitarist74 folded before Flop (didn't bet)
Seat 3: Bula71 (button) folded before Flop (didn't bet)
Seat 4: reginaph (small blind) folded before Flop
Seat 5: yzuk (big blind) folded before Flop
Seat 6: grandarino collected ($1.25)


PokerStars Hand #208978450585:  Hold'em No Limit ($0.25/$0.50 USD) - 2020/02/08 12:38:22 ET
Table 'Acamar V' 6-max Seat #2 is the button
Seat 1: beerjoe984 ($86.09 in chips)
Seat 2: gitarist74 ($50.39 in chips)
Seat 3: Bula71 ($50 in chips)
Seat 4: reginaph ($50 in chips)
Seat 5: yzuk ($54.59 in chips)
Seat 6: grandarino ($80.42 in chips)
Bula71: posts small blind $0.25
reginaph: posts big blind $0.50
*** HOLE CARDS ***
yzuk: folds
grandarino: raises $0.75 to $1.25
beerjoe984: calls $1.25
gitarist74: folds
Bula71: folds
reginaph: calls $0.75
*** FLOP *** [7c 5c 7s]
reginaph: checks
grandarino: checks
beerjoe984: checks
*** TURN *** [7c 5c 7s] [2s]
reginaph: checks
grandarino: bets $3
beerjoe984: folds
reginaph: folds
Uncalled bet ($3) returned to grandarino
grandarino collected $3.80 from pot
grandarino: doesn't show hand
*** SUMMARY ***
Total pot $4 | Rake $0.20
Board [7c 5c 7s 2s]
Seat 1: beerjoe984 folded on the Turn
Seat 2: gitarist74 (button) folded before Flop (didn't bet)
Seat 3: Bula71 (small blind) folded before Flop
Seat 4: reginaph (big blind) folded on the Turn
Seat 5: yzuk folded before Flop (didn't bet)
Seat 6: grandarino collected ($3.80)


PokerStars Hand #208978483104:  Hold'em No Limit ($0.25/$0.50 USD) - 2020/02/08 12:39:19 ET
Table 'Acamar V' 6-max Seat #4 is the button
Seat 1: beerjoe984 ($84.84 in chips)
Seat 2: gitarist74 ($50.39 in chips)
Seat 3: Bula71 ($50 in chips)
Seat 4: reginaph ($50 in chips)
Seat 5: yzuk ($54.09 in chips)
Seat 6: grandarino ($83.72 in chips)
yzuk: posts small blind $0.25
grandarino: posts big blind $0.50
*** HOLE CARDS ***
beerjoe984: folds
gitarist74: folds
Bula71: folds
reginaph: folds
yzuk: raises $1 to $1.50
grandarino: raises $3 to $4.50
yzuk: calls $3
*** FLOP *** [8h 4d Ac]
yzuk: checks
grandarino: checks
*** TURN *** [8h 4d Ac] [Kc]
yzuk: checks
grandarino: bets $3.25
yzuk: folds
Uncalled bet ($3.25) returned to grandarino
grandarino collected $8.55 from pot
grandarino: doesn't show hand
*** SUMMARY ***
Total pot $9 | Rake $0.45
Board [8h 4d Ac Kc]
Seat 1: beerjoe984 folded before Flop (didn't bet)
Seat 2: gitarist74 folded before Flop (didn't bet)
Seat 3: Bula71 folded before Flop (didn't bet)
Seat 4: reginaph (button) folded before Flop (didn't bet)
Seat 5: yzuk (small blind) folded on the Turn
Seat 6: grandarino (big blind) collected ($8.55)


PokerStars Hand #208978520635:  Hold'em No Limit ($0.25/$0.50 USD) - 2020/02/08 12:40:25 ET
Table 'Acamar V' 6-max Seat #5 is the button
Seat 1: beerjoe984 ($84.84 in chips)
Seat 2: gitarist74 ($50.39 in chips)
Seat 3: Bula71 ($50 in chips)
Seat 4: reginaph ($50 in chips)
Seat 5: yzuk ($50 in chips)
Seat 6: grandarino ($87.77 in chips)
grandarino: posts small blind $0.25
beerjoe984: posts big blind $0.50
*** HOLE CARDS ***
gitarist74: raises $0.90 to $1.40
Bula71: folds
reginaph: folds
yzuk: folds
grandarino: folds
beerjoe984: raises $0.90 to $2.30
gitarist74: calls $0.90
*** FLOP *** [Ac Qd 9c]
beerjoe984: bets $2.50
gitarist74: calls $2.50
*** TURN *** [Ac Qd 9c] [2h]
beerjoe984: bets $4.50
gitarist74: folds
Uncalled bet ($4.50) returned to beerjoe984
beerjoe984 collected $9.36 from pot
beerjoe984: doesn't show hand
*** SUMMARY ***
Total pot $9.85 | Rake $0.49
Board [Ac Qd 9c 2h]
Seat 1: beerjoe984 (big blind) collected ($9.36)
Seat 2: gitarist74 folded on the Turn
Seat 3: Bula71 folded before Flop (didn't bet)
Seat 4: reginaph folded before Flop (didn't bet)
Seat 5: yzuk (button) folded before Flop (didn't bet)
Seat 6: grandarino (small blind) folded before Flop


PokerStars Hand #208978597113:  Hold'em No Limit ($0.25/$0.50 USD) - 2020/02/08 12:42:27 ET
Table 'Acamar V' 6-max Seat #2 is the button
Seat 1: beerjoe984 ($94.18 in chips)
Seat 2: gitarist74 ($50 in chips)
Seat 3: Bula71 ($52.06 in chips)
Seat 4: reginaph ($50 in chips)
Seat 5: yzuk ($50 in chips)
Seat 6: grandarino ($87.52 in chips)
Bula71: posts small blind $0.25
reginaph: posts big blind $0.50
*** HOLE CARDS ***
yzuk: folds
grandarino: folds
beerjoe984: folds
gitarist74: folds
yzuk leaves the table
Bula71: folds
Uncalled bet ($0.25) returned to reginaph
reginaph collected $0.50 from pot
reginaph: doesn't show hand
*** SUMMARY ***
Total pot $0.50 | Rake $0
Seat 1: beerjoe984 folded before Flop (didn't bet)
Seat 2: gitarist74 (button) folded before Flop (didn't bet)
Seat 3: Bula71 (small blind) folded before Flop
Seat 4: reginaph (big blind) collected ($0.50)
Seat 5: yzuk folded before Flop (didn't bet)
Seat 6: grandarino folded before Flop (didn't bet)


PokerStars Hand #208978568707:  Hold'em No Limit ($0.25/$0.50 USD) - 2020/02/08 12:41:48 ET
Table 'Acamar V' 6-max Seat #1 is the button
Seat 1: beerjoe984 ($94.18 in chips)
Seat 2: gitarist74 ($50 in chips)
Seat 3: Bula71 ($50 in chips)
Seat 4: reginaph ($50 in chips)
Seat 5: yzuk ($50 in chips)
Seat 6: grandarino ($87.52 in chips)
gitarist74: posts small blind $0.25
Bula71: posts big blind $0.50
*** HOLE CARDS ***
reginaph: raises $0.75 to $1.25
yzuk: folds
grandarino: folds
beerjoe984: folds
gitarist74: folds
Bula71: calls $0.75
*** FLOP *** [6c 2d 3d]
Bula71: checks
reginaph: bets $0.78
Bula71: raises $2.72 to $3.50
reginaph: folds
Uncalled bet ($2.72) returned to Bula71
Bula71 collected $4.09 from pot
Bula71: doesn't show hand
*** SUMMARY ***
Total pot $4.31 | Rake $0.22
Board [6c 2d 3d]
Seat 1: beerjoe984 (button) folded before Flop (didn't bet)
Seat 2: gitarist74 (small blind) folded before Flop
Seat 3: Bula71 (big blind) collected ($4.09)
Seat 4: reginaph folded on the Flop
Seat 5: yzuk folded before Flop (didn't bet)
Seat 6: grandarino folded before Flop (didn't bet)


PokerStars Hand #208978542678:  Hold'em No Limit ($0.25/$0.50 USD) - 2020/02/08 12:41:02 ET
Table 'Acamar V' 6-max Seat #6 is the button
Seat 1: beerjoe984 ($89.40 in chips)
Seat 2: gitarist74 ($50 in chips)
Seat 3: Bula71 ($50 in chips)
Seat 4: reginaph ($50 in chips)
Seat 5: yzuk ($50 in chips)
Seat 6: grandarino ($87.52 in chips)
beerjoe984: posts small blind $0.25
gitarist74: posts big blind $0.50
*** HOLE CARDS ***
Bula71: folds
reginaph: folds
yzuk: raises $0.75 to $1.25
grandarino: folds
beerjoe984: calls $1
gitarist74: calls $0.75
*** FLOP *** [9d 8c Jd]
beerjoe984: checks
gitarist74: checks
yzuk: bets $2.74
beerjoe984: calls $2.74
gitarist74: folds
*** TURN *** [9d 8c Jd] [7d]
beerjoe984: bets $4.50
yzuk: folds
Uncalled bet ($4.50) returned to beerjoe984
beerjoe984 collected $8.77 from pot
beerjoe984: doesn't show hand
*** SUMMARY ***
Total pot $9.23 | Rake $0.46
Board [9d 8c Jd 7d]
Seat 1: beerjoe984 (small blind) collected ($8.77)
Seat 2: gitarist74 (big blind) folded on the Flop
Seat 3: Bula71 folded before Flop (didn't bet)
Seat 4: reginaph folded before Flop (didn't bet)
Seat 5: yzuk folded on the Turn
Seat 6: grandarino (button) folded before Flop (didn't bet)


PokerStars Hand #208978603317:  Hold'em No Limit ($0.25/$0.50 USD) - 2020/02/08 12:42:38 ET
Table 'Acamar V' 6-max Seat #3 is the button
Seat 1: beerjoe984 ($94.18 in chips)
Seat 2: gitarist74 ($50 in chips)
Seat 3: Bula71 ($51.81 in chips)
Seat 4: reginaph ($50.25 in chips)
Seat 6: grandarino ($87.52 in chips)
reginaph: posts small blind $0.25
grandarino: posts big blind $0.50
*** HOLE CARDS ***
beerjoe984: folds
gitarist74: folds
Bula71: raises $0.75 to $1.25
reginaph: folds
grandarino: calls $0.75
*** FLOP *** [6h 5s 2s]
grandarino: checks
Bula71: checks
*** TURN *** [6h 5s 2s] [8c]
grandarino: bets $1.25
Bula71: calls $1.25
*** RIVER *** [6h 5s 2s 8c] [9h]
grandarino: checks
Bula71: bets $9.63
Sensei2212 joins the table at seat #5
grandarino: calls $9.63
*** SHOW DOWN ***
Bula71: shows [7d Qd] (a straight, Five to Nine)
grandarino: mucks hand
Bula71 collected $23.28 from pot
*** SUMMARY ***
Total pot $24.51 | Rake $1.23
Board [6h 5s 2s 8c 9h]
Seat 1: beerjoe984 folded before Flop (didn't bet)
Seat 2: gitarist74 folded before Flop (didn't bet)
Seat 3: Bula71 (button) showed [7d Qd] and won ($23.28) with a straight, Five to Nine
Seat 4: reginaph (small blind) folded before Flop
Seat 6: grandarino (big blind) mucked


PokerStars Hand #208978647961:  Hold'em No Limit ($0.25/$0.50 USD) - 2020/02/08 12:43:56 ET
Table 'Acamar V' 6-max Seat #4 is the button
Seat 1: beerjoe984 ($94.18 in chips)
Seat 2: gitarist74 ($50 in chips)
Seat 3: Bula71 ($62.96 in chips)
Seat 4: reginaph ($50 in chips)
Seat 6: grandarino ($75.39 in chips)
grandarino: posts small blind $0.25
beerjoe984: posts big blind $0.50
*** HOLE CARDS ***
gitarist74: folds
Bula71: folds
reginaph: folds
grandarino: raises $1.25 to $1.75
beerjoe984: raises $1.25 to $3
grandarino: calls $1.25
*** FLOP *** [Ah 8d Qh]
grandarino: checks
beerjoe984: bets $3
grandarino: calls $3
*** TURN *** [Ah 8d Qh] [9d]
grandarino: checks
beerjoe984: bets $5.50
grandarino: calls $5.50
*** RIVER *** [Ah 8d Qh 9d] [2s]
grandarino: checks
beerjoe984: bets $11
grandarino: folds
Uncalled bet ($11) returned to beerjoe984
beerjoe984 collected $21.85 from pot
beerjoe984: doesn't show hand
*** SUMMARY ***
Total pot $23 | Rake $1.15
Board [Ah 8d Qh 9d 2s]
Seat 1: beerjoe984 (big blind) collected ($21.85)
Seat 2: gitarist74 folded before Flop (didn't bet)
Seat 3: Bula71 folded before Flop (didn't bet)
Seat 4: reginaph (button) folded before Flop (didn't bet)
Seat 6: grandarino (small blind) folded on the River


PokerStars Hand #208978679843:  Hold'em No Limit ($0.25/$0.50 USD) - 2020/02/08 12:44:53 ET
Table 'Acamar V' 6-max Seat #6 is the button
Seat 1: beerjoe984 ($104.53 in chips)
Seat 2: gitarist74 ($50 in chips)
Seat 3: Bula71 ($62.96 in chips)
Seat 4: reginaph ($50 in chips)
Seat 6: grandarino ($63.89 in chips)
beerjoe984: posts small blind $0.25
gitarist74: posts big blind $0.50
Sensei2212: sits out
*** HOLE CARDS ***
Bula71: calls $0.50
reginaph: folds
grandarino: folds
beerjoe984: calls $0.25
gitarist74: checks
*** FLOP *** [8c Ah Jc]
beerjoe984: bets $0.50
gitarist74: calls $0.50
Bula71: folds
*** TURN *** [8c Ah Jc] [6s]
beerjoe984: bets $1
gitarist74: calls $1
*** RIVER *** [8c Ah Jc 6s] [Qh]
beerjoe984: bets $0.50
gitarist74: folds
Uncalled bet ($0.50) returned to beerjoe984
beerjoe984 collected $4.28 from pot
beerjoe984: doesn't show hand
*** SUMMARY ***
Total pot $4.50 | Rake $0.22
Board [8c Ah Jc 6s Qh]
Seat 1: beerjoe984 (small blind) collected ($4.28)
Seat 2: gitarist74 (big blind) folded on the River
Seat 3: Bula71 folded on the Flop
Seat 4: reginaph folded before Flop (didn't bet)
Seat 6: grandarino (button) folded before Flop (didn't bet)


PokerStars Hand #208978710563:  Hold'em No Limit ($0.25/$0.50 USD) - 2020/02/08 12:45:46 ET
Table 'Acamar V' 6-max Seat #1 is the button
Seat 1: beerjoe984 ($106.81 in chips)
Seat 2: gitarist74 ($50 in chips)
Seat 3: Bula71 ($62.46 in chips)
Seat 4: reginaph ($50 in chips)
Seat 6: grandarino ($63.89 in chips)
gitarist74: posts small blind $0.25
Bula71: posts big blind $0.50
Sensei2212: sits out
*** HOLE CARDS ***
reginaph: raises $0.75 to $1.25
grandarino: folds
beerjoe984: calls $1.25
gitarist74: raises $5.75 to $7
Bula71: folds
reginaph: calls $5.75
beerjoe984: folds
*** FLOP *** [9s Qs Jd]
gitarist74: checks
reginaph: checks
*** TURN *** [9s Qs Jd] [2h]
gitarist74: bets $5.98
reginaph: calls $5.98
*** RIVER *** [9s Qs Jd 2h] [5c]
gitarist74: bets $15.79
reginaph: folds
Uncalled bet ($15.79) returned to gitarist74
gitarist74 collected $26.32 from pot
*** SUMMARY ***
Total pot $27.71 | Rake $1.39
Board [9s Qs Jd 2h 5c]
Seat 1: beerjoe984 (button) folded before Flop
Seat 2: gitarist74 (small blind) collected ($26.32)
Seat 3: Bula71 (big blind) folded before Flop
Seat 4: reginaph folded on the River
Seat 6: grandarino folded before Flop (didn't bet)


PokerStars Hand #208978767191:  Hold'em No Limit ($0.25/$0.50 USD) - 2020/02/08 12:47:26 ET
Table 'Acamar V' 6-max Seat #2 is the button
Seat 1: beerjoe984 ($105.56 in chips)
Seat 2: gitarist74 ($63.34 in chips)
Seat 3: Bula71 ($61.96 in chips)
Seat 4: reginaph ($50 in chips)
Seat 6: grandarino ($63.89 in chips)
Bula71: posts small blind $0.25
reginaph: posts big blind $0.50
Sensei2212: sits out
*** HOLE CARDS ***
grandarino: folds
beerjoe984: folds
gitarist74: raises $0.75 to $1.25
Bula71: folds
reginaph: folds
Uncalled bet ($0.75) returned to gitarist74
gitarist74 collected $1.25 from pot
*** SUMMARY ***
Total pot $1.25 | Rake $0
Seat 1: beerjoe984 folded before Flop (didn't bet)
Seat 2: gitarist74 (button) collected ($1.25)
Seat 3: Bula71 (small blind) folded before Flop
Seat 4: reginaph (big blind) folded before Flop
Seat 6: grandarino folded before Flop (didn't bet)


PokerStars Hand #208978775908:  Hold'em No Limit ($0.25/$0.50 USD) - 2020/02/08 12:47:41 ET
Table 'Acamar V' 6-max Seat #3 is the button
Seat 1: beerjoe984 ($105.56 in chips)
Seat 2: gitarist74 ($64.09 in chips)
Seat 3: Bula71 ($61.71 in chips)
Seat 4: reginaph ($50 in chips)
Seat 5: Sensei2212 ($50 in chips)
Seat 6: grandarino ($63.89 in chips)
reginaph: posts small blind $0.25
Sensei2212: posts big blind $0.50
*** HOLE CARDS ***
grandarino: folds
beerjoe984: raises $0.50 to $1
gitarist74: folds
Bula71: folds
reginaph: folds
Sensei2212: folds
Uncalled bet ($0.50) returned to beerjoe984
beerjoe984 collected $1.25 from pot
beerjoe984: doesn't show hand
*** SUMMARY ***
Total pot $1.25 | Rake $0
Seat 1: beerjoe984 collected ($1.25)
Seat 2: gitarist74 folded before Flop (didn't bet)
Seat 3: Bula71 (button) folded before Flop (didn't bet)
Seat 4: reginaph (small blind) folded before Flop
Seat 5: Sensei2212 (big blind) folded before Flop
Seat 6: grandarino folded before Flop (didn't bet)


PokerStars Hand #208978790056:  Hold'em No Limit ($0.25/$0.50 USD) - 2020/02/08 12:48:06 ET
Table 'Acamar V' 6-max Seat #4 is the button
Seat 1: beerjoe984 ($106.31 in chips)
Seat 2: gitarist74 ($64.09 in chips)
Seat 3: Bula71 ($61.71 in chips)
Seat 4: reginaph ($50 in chips)
Seat 5: Sensei2212 ($50 in chips)
Seat 6: grandarino ($63.89 in chips)
Sensei2212: posts small blind $0.25
grandarino: posts big blind $0.50
*** HOLE CARDS ***
beerjoe984: raises $0.50 to $1
gitarist74: folds
Bula71: folds
reginaph: folds
Sensei2212: folds
grandarino: folds
Uncalled bet ($0.50) returned to beerjoe984
beerjoe984 collected $1.25 from pot
beerjoe984: doesn't show hand
*** SUMMARY ***
Total pot $1.25 | Rake $0
Seat 1: beerjoe984 collected ($1.25)
Seat 2: gitarist74 folded before Flop (didn't bet)
Seat 3: Bula71 folded before Flop (didn't bet)
Seat 4: reginaph (button) folded before Flop (didn't bet)
Seat 5: Sensei2212 (small blind) folded before Flop
Seat 6: grandarino (big blind) folded before Flop


PokerStars Hand #208978799780:  Hold'em No Limit ($0.25/$0.50 USD) - 2020/02/08 12:48:23 ET
Table 'Acamar V' 6-max Seat #5 is the button
Seat 1: beerjoe984 ($107.06 in chips)
Seat 2: gitarist74 ($64.09 in chips)
Seat 3: Bula71 ($61.71 in chips)
Seat 4: reginaph ($50 in chips)
Seat 5: Sensei2212 ($50 in chips)
Seat 6: grandarino ($63.39 in chips)
grandarino: posts small blind $0.25
beerjoe984: posts big blind $0.50
*** HOLE CARDS ***
gitarist74: raises $0.90 to $1.40
Bula71: folds
reginaph: folds
Sensei2212: folds
grandarino: folds
beerjoe984: calls $0.90
*** FLOP *** [9c 7c 9h]
beerjoe984: bets $1.50
gitarist74: calls $1.50
*** TURN *** [9c 7c 9h] [Ts]
beerjoe984: bets $3
gitarist74: folds
Uncalled bet ($3) returned to beerjoe984
beerjoe984 collected $5.75 from pot
beerjoe984: doesn't show hand
*** SUMMARY ***
Total pot $6.05 | Rake $0.30
Board [9c 7c 9h Ts]
Seat 1: beerjoe984 (big blind) collected ($5.75)
Seat 2: gitarist74 folded on the Turn
Seat 3: Bula71 folded before Flop (didn't bet)
Seat 4: reginaph folded before Flop (didn't bet)
Seat 5: Sensei2212 (button) folded before Flop (didn't bet)
Seat 6: grandarino (small blind) folded before Flop


PokerStars Hand #208978827100:  Hold'em No Limit ($0.25/$0.50 USD) - 2020/02/08 12:49:11 ET
Table 'Acamar V' 6-max Seat #6 is the button
Seat 1: beerjoe984 ($109.91 in chips)
Seat 2: gitarist74 ($61.19 in chips)
Seat 3: Bula71 ($61.71 in chips)
Seat 4: reginaph ($50 in chips)
Seat 5: Sensei2212 ($50 in chips)
Seat 6: grandarino ($63.14 in chips)
beerjoe984: posts small blind $0.25
gitarist74: posts big blind $0.50
*** HOLE CARDS ***
Bula71: folds
reginaph: folds
Sensei2212: raises $0.70 to $1.20
grandarino: folds
beerjoe984: calls $0.95
gitarist74: folds
*** FLOP *** [5s Qc Qd]
beerjoe984: bets $1.50
Sensei2212: calls $1.50
*** TURN *** [5s Qc Qd] [Jd]
beerjoe984: bets $3
Sensei2212: calls $3
*** RIVER *** [5s Qc Qd Jd] [6s]
beerjoe984: bets $5.50
Sensei2212: folds
Uncalled bet ($5.50) returned to beerjoe984
beerjoe984 collected $11.30 from pot
beerjoe984: doesn't show hand
*** SUMMARY ***
Total pot $11.90 | Rake $0.60
Board [5s Qc Qd Jd 6s]
Seat 1: beerjoe984 (small blind) collected ($11.30)
Seat 2: gitarist74 (big blind) folded before Flop
Seat 3: Bula71 folded before Flop (didn't bet)
Seat 4: reginaph folded before Flop (didn't bet)
Seat 5: Sensei2212 folded on the River
Seat 6: grandarino (button) folded before Flop (didn't bet)


PokerStars Hand #208978858771:  Hold'em No Limit ($0.25/$0.50 USD) - 2020/02/08 12:50:06 ET
Table 'Acamar V' 6-max Seat #2 is the button
Seat 1: beerjoe984 ($115.51 in chips)
Seat 2: gitarist74 ($60.44 in chips)
Seat 3: Bula71 ($61.21 in chips)
Seat 4: reginaph ($50.75 in chips)
Seat 5: Sensei2212 ($50 in chips)
Seat 6: grandarino ($63.14 in chips)
Bula71: posts small blind $0.25
reginaph: posts big blind $0.50
*** HOLE CARDS ***
Sensei2212: folds
grandarino: folds
beerjoe984: folds
gitarist74: raises $0.75 to $1.25
Bula71: folds
reginaph: raises $3.75 to $5
gitarist74: calls $3.75
*** FLOP *** [Qd Ah Ts]
reginaph: bets $2.92
gitarist74: folds
Uncalled bet ($2.92) returned to reginaph
reginaph collected $9.74 from pot
reginaph: doesn't show hand
*** SUMMARY ***
Total pot $10.25 | Rake $0.51
Board [Qd Ah Ts]
Seat 1: beerjoe984 folded before Flop (didn't bet)
Seat 2: gitarist74 (button) folded on the Flop
Seat 3: Bula71 (small blind) folded before Flop
Seat 4: reginaph (big blind) collected ($9.74)
Seat 5: Sensei2212 folded before Flop (didn't bet)
Seat 6: grandarino folded before Flop (didn't bet)


PokerStars Hand #208978848819:  Hold'em No Limit ($0.25/$0.50 USD) - 2020/02/08 12:49:49 ET
Table 'Acamar V' 6-max Seat #1 is the button
Seat 1: beerjoe984 ($115.51 in chips)
Seat 2: gitarist74 ($60.69 in chips)
Seat 3: Bula71 ($61.71 in chips)
Seat 4: reginaph ($50 in chips)
Seat 5: Sensei2212 ($50 in chips)
Seat 6: grandarino ($63.14 in chips)
gitarist74: posts small blind $0.25
Bula71: posts big blind $0.50
*** HOLE CARDS ***
reginaph: raises $0.75 to $1.25
Sensei2212: folds
grandarino: folds
beerjoe984: folds
gitarist74: folds
Bula71: folds
Uncalled bet ($0.75) returned to reginaph
reginaph collected $1.25 from pot
reginaph: doesn't show hand
*** SUMMARY ***
Total pot $1.25 | Rake $0
Seat 1: beerjoe984 (button) folded before Flop (didn't bet)
Seat 2: gitarist74 (small blind) folded before Flop
Seat 3: Bula71 (big blind) folded before Flop
Seat 4: reginaph collected ($1.25)
Seat 5: Sensei2212 folded before Flop (didn't bet)
Seat 6: grandarino folded before Flop (didn't bet)


PokerStars Hand #208978876180:  Hold'em No Limit ($0.25/$0.50 USD) - 2020/02/08 12:50:37 ET
Table 'Acamar V' 6-max Seat #3 is the button
Seat 1: beerjoe984 ($115.51 in chips)
Seat 2: gitarist74 ($55.44 in chips)
Seat 3: Bula71 ($60.96 in chips)
Seat 4: reginaph ($55.49 in chips)
Seat 5: Sensei2212 ($50 in chips)
Seat 6: grandarino ($63.14 in chips)
reginaph: posts small blind $0.25
Sensei2212: posts big blind $0.50
*** HOLE CARDS ***
grandarino: folds
beerjoe984: folds
gitarist74: folds
Bula71: raises $0.75 to $1.25
reginaph: folds
Sensei2212: raises $3.75 to $5
Bula71: folds
Uncalled bet ($3.75) returned to Sensei2212
Sensei2212 collected $2.75 from pot
Sensei2212: doesn't show hand
*** SUMMARY ***
Total pot $2.75 | Rake $0
Seat 1: beerjoe984 folded before Flop (didn't bet)
Seat 2: gitarist74 folded before Flop (didn't bet)
Seat 3: Bula71 (button) folded before Flop
Seat 4: reginaph (small blind) folded before Flop
Seat 5: Sensei2212 (big blind) collected ($2.75)
Seat 6: grandarino folded before Flop (didn't bet)


PokerStars Hand #208978887121:  Hold'em No Limit ($0.25/$0.50 USD) - 2020/02/08 12:50:56 ET
Table 'Acamar V' 6-max Seat #4 is the button
Seat 1: beerjoe984 ($115.51 in chips)
Seat 2: gitarist74 ($55.44 in chips)
Seat 3: Bula71 ($59.71 in chips)
Seat 4: reginaph ($55.24 in chips)
Seat 5: Sensei2212 ($51.50 in chips)
Seat 6: grandarino ($63.14 in chips)
Sensei2212: posts small blind $0.25
grandarino: posts big blind $0.50
*** HOLE CARDS ***
beerjoe984: raises $0.50 to $1
gitarist74: folds
Bula71: folds
reginaph: folds
Sensei2212: folds
grandarino: calls $0.50
*** FLOP *** [Ad 8c 6h]
grandarino: checks
beerjoe984: bets $1
grandarino: folds
Uncalled bet ($1) returned to beerjoe984
beerjoe984 collected $2.14 from pot
beerjoe984: doesn't show hand
*** SUMMARY ***
Total pot $2.25 | Rake $0.11
Board [Ad 8c 6h]
Seat 1: beerjoe984 collected ($2.14)
Seat 2: gitarist74 folded before Flop (didn't bet)
Seat 3: Bula71 folded before Flop (didn't bet)
Seat 4: reginaph (button) folded before Flop (didn't bet)
Seat 5: Sensei2212 (small blind) folded before Flop
Seat 6: grandarino (big blind) folded on the Flop


PokerStars Hand #208978903338:  Hold'em No Limit ($0.25/$0.50 USD) - 2020/02/08 12:51:25 ET
Table 'Acamar V' 6-max Seat #5 is the button
Seat 1: beerjoe984 ($116.65 in chips)
Seat 2: gitarist74 ($55.44 in chips)
Seat 3: Bula71 ($59.71 in chips)
Seat 4: reginaph ($55.24 in chips)
Seat 5: Sensei2212 ($51.25 in chips)
Seat 6: grandarino ($62.14 in chips)
grandarino: posts small blind $0.25
beerjoe984: posts big blind $0.50
*** HOLE CARDS ***
gitarist74: folds
Bula71: folds
reginaph: raises $0.75 to $1.25
Sensei2212: folds
grandarino: folds
beerjoe984: calls $0.75
*** FLOP *** [Ah 2c 4h]
beerjoe984: bets $1.50
reginaph: calls $1.50
*** TURN *** [Ah 2c 4h] [Kc]
beerjoe984: bets $2.50
reginaph: calls $2.50
*** RIVER *** [Ah 2c 4h Kc] [As]
beerjoe984: bets $5
reginaph: calls $5
*** SHOW DOWN ***
beerjoe984: shows [5s 5c] (two pair, Aces and Fives)
reginaph: shows [8h 8s] (two pair, Aces and Eights)
reginaph collected $19.71 from pot
*** SUMMARY ***
Total pot $20.75 | Rake $1.04
Board [Ah 2c 4h Kc As]
Seat 1: beerjoe984 (big blind) showed [5s 5c] and lost with two pair, Aces and Fives
Seat 2: gitarist74 folded before Flop (didn't bet)
Seat 3: Bula71 folded before Flop (didn't bet)
Seat 4: reginaph showed [8h 8s] and won ($19.71) with two pair, Aces and Eights
Seat 5: Sensei2212 (button) folded before Flop (didn't bet)
Seat 6: grandarino (small blind) folded before Flop


PokerStars Hand #208978983571:  Hold'em No Limit ($0.25/$0.50 USD) - 2020/02/08 12:53:48 ET
Table 'Acamar V' 6-max Seat #1 is the button
Seat 1: beerjoe984 ($148.64 in chips)
Seat 2: gitarist74 ($50 in chips)
Seat 3: Bula71 ($59.71 in chips)
Seat 4: reginaph ($64.70 in chips)
Seat 5: Sensei2212 ($50 in chips)
Seat 6: grandarino ($61.89 in chips)
gitarist74: posts small blind $0.25
Bula71: posts big blind $0.50
*** HOLE CARDS ***
reginaph: folds
Sensei2212: folds
grandarino: folds
beerjoe984: folds
gitarist74: folds
Uncalled bet ($0.25) returned to Bula71
Bula71 collected $0.50 from pot
Bula71: doesn't show hand
*** SUMMARY ***
Total pot $0.50 | Rake $0
Seat 1: beerjoe984 (button) folded before Flop (didn't bet)
Seat 2: gitarist74 (small blind) folded before Flop
Seat 3: Bula71 (big blind) collected ($0.50)
Seat 4: reginaph folded before Flop (didn't bet)
Seat 5: Sensei2212 folded before Flop (didn't bet)
Seat 6: grandarino folded before Flop (didn't bet)


PokerStars Hand #208978938646:  Hold'em No Limit ($0.25/$0.50 USD) - 2020/02/08 12:52:28 ET
Table 'Acamar V' 6-max Seat #6 is the button
Seat 1: beerjoe984 ($106.40 in chips)
Seat 2: gitarist74 ($55.44 in chips)
Seat 3: Bula71 ($59.71 in chips)
Seat 4: reginaph ($64.70 in chips)
Seat 5: Sensei2212 ($51.25 in chips)
Seat 6: grandarino ($61.89 in chips)
beerjoe984: posts small blind $0.25
gitarist74: posts big blind $0.50
*** HOLE CARDS ***
Bula71: folds
reginaph: folds
Sensei2212: raises $0.60 to $1.10
grandarino: folds
beerjoe984: raises $0.60 to $1.70
gitarist74: calls $1.20
Sensei2212: calls $0.60
*** FLOP *** [4s Ks 6d]
beerjoe984: bets $2.50
gitarist74: raises $4.92 to $7.42
Sensei2212: calls $7.42
beerjoe984: calls $4.92
*** TURN *** [4s Ks 6d] [Tc]
beerjoe984: bets $13
gitarist74: calls $13
Sensei2212: calls $13
*** RIVER *** [4s Ks 6d Tc] [8c]
beerjoe984: bets $32
gitarist74: folds
Sensei2212: folds
Uncalled bet ($32) returned to beerjoe984
beerjoe984 collected $64.36 from pot
beerjoe984: doesn't show hand
*** SUMMARY ***
Total pot $66.36 | Rake $2
Board [4s Ks 6d Tc 8c]
Seat 1: beerjoe984 (small blind) collected ($64.36)
Seat 2: gitarist74 (big blind) folded on the River
Seat 3: Bula71 folded before Flop (didn't bet)
Seat 4: reginaph folded before Flop (didn't bet)
Seat 5: Sensei2212 folded on the River
Seat 6: grandarino (button) folded before Flop (didn't bet)


PokerStars Hand #208979000590:  Hold'em No Limit ($0.25/$0.50 USD) - 2020/02/08 12:54:03 ET
Table 'Acamar V' 6-max Seat #2 is the button
Seat 1: beerjoe984 ($148.64 in chips)
Seat 2: gitarist74 ($50 in chips)
Seat 3: Bula71 ($59.96 in chips)
Seat 4: reginaph ($64.70 in chips)
Seat 5: Sensei2212 ($50 in chips)
Seat 6: grandarino ($61.89 in chips)
Bula71: posts small blind $0.25
reginaph: posts big blind $0.50
*** HOLE CARDS ***
Sensei2212: folds
grandarino: raises $0.75 to $1.25
beerjoe984: folds
gitarist74: folds
Bula71: folds
reginaph: folds
Uncalled bet ($0.75) returned to grandarino
grandarino collected $1.25 from pot
grandarino: doesn't show hand
*** SUMMARY ***
Total pot $1.25 | Rake $0
Seat 1: beerjoe984 folded before Flop (didn't bet)
Seat 2: gitarist74 (button) folded before Flop (didn't bet)
Seat 3: Bula71 (small blind) folded before Flop
Seat 4: reginaph (big blind) folded before Flop
Seat 5: Sensei2212 folded before Flop (didn't bet)
Seat 6: grandarino collected ($1.25)


PokerStars Hand #208979020077:  Hold'em No Limit ($0.25/$0.50 USD) - 2020/02/08 12:54:38 ET
Table 'Acamar V' 6-max Seat #3 is the button
Seat 1: beerjoe984 ($148.64 in chips)
Seat 2: gitarist74 ($50 in chips)
Seat 3: Bula71 ($59.71 in chips)
Seat 4: reginaph ($64.20 in chips)
Seat 5: Sensei2212 ($50 in chips)
Seat 6: grandarino ($62.64 in chips)
reginaph: posts small blind $0.25
Sensei2212: posts big blind $0.50
*** HOLE CARDS ***
grandarino: folds
beerjoe984: raises $0.50 to $1
gitarist74: folds
Bula71: calls $1
reginaph: folds
Sensei2212: calls $0.50
*** FLOP *** [6d 4h 5c]
Sensei2212: checks
beerjoe984: bets $0.50
Bula71: raises $2.25 to $2.75
Sensei2212: folds
beerjoe984: calls $2.25
*** TURN *** [6d 4h 5c] [Ad]
beerjoe984: bets $4
Bula71: calls $4
*** RIVER *** [6d 4h 5c Ad] [Qd]
beerjoe984: bets $8
Bula71: calls $8
*** SHOW DOWN ***
beerjoe984: shows [5s 3s] (a pair of Fives)
Bula71: shows [6s 8s] (a pair of Sixes)
Bula71 collected $31.11 from pot
*** SUMMARY ***
Total pot $32.75 | Rake $1.64
Board [6d 4h 5c Ad Qd]
Seat 1: beerjoe984 showed [5s 3s] and lost with a pair of Fives
Seat 2: gitarist74 folded before Flop (didn't bet)
Seat 3: Bula71 (button) showed [6s 8s] and won ($31.11) with a pair of Sixes
Seat 4: reginaph (small blind) folded before Flop
Seat 5: Sensei2212 (big blind) folded on the Flop
Seat 6: grandarino folded before Flop (didn't bet)


PokerStars Hand #208979045227:  Hold'em No Limit ($0.25/$0.50 USD) - 2020/02/08 12:55:24 ET
Table 'Acamar V' 6-max Seat #4 is the button
Seat 1: beerjoe984 ($132.89 in chips)
Seat 2: gitarist74 ($50 in chips)
Seat 3: Bula71 ($75.07 in chips)
Seat 4: reginaph ($63.95 in chips)
Seat 5: Sensei2212 ($50 in chips)
Seat 6: grandarino ($62.64 in chips)
Sensei2212: posts small blind $0.25
grandarino: posts big blind $0.50
*** HOLE CARDS ***
beerjoe984: raises $0.50 to $1
gitarist74: folds
Bula71: folds
reginaph: folds
Sensei2212: folds
grandarino: folds
Uncalled bet ($0.50) returned to beerjoe984
beerjoe984 collected $1.25 from pot
beerjoe984: doesn't show hand
*** SUMMARY ***
Total pot $1.25 | Rake $0
Seat 1: beerjoe984 collected ($1.25)
Seat 2: gitarist74 folded before Flop (didn't bet)
Seat 3: Bula71 folded before Flop (didn't bet)
Seat 4: reginaph (button) folded before Flop (didn't bet)
Seat 5: Sensei2212 (small blind) folded before Flop
Seat 6: grandarino (big blind) folded before Flop


PokerStars Hand #208979052380:  Hold'em No Limit ($0.25/$0.50 USD) - 2020/02/08 12:55:41 ET
Table 'Acamar V' 6-max Seat #5 is the button
Seat 1: beerjoe984 ($133.64 in chips)
Seat 2: gitarist74 ($50 in chips)
Seat 3: Bula71 ($75.07 in chips)
Seat 4: reginaph ($63.95 in chips)
Seat 5: Sensei2212 ($50 in chips)
Seat 6: grandarino ($62.14 in chips)
grandarino: posts small blind $0.25
beerjoe984: posts big blind $0.50
*** HOLE CARDS ***
gitarist74: raises $0.90 to $1.40
Bula71: raises $2.90 to $4.30
reginaph: folds
Sensei2212: folds
grandarino: folds
beerjoe984: calls $3.80
gitarist74: folds
*** FLOP *** [3h 8c 8s]
beerjoe984: checks
Bula71: bets $6.50
beerjoe984: calls $6.50
*** TURN *** [3h 8c 8s] [Th]
beerjoe984: checks
Bula71: checks
*** RIVER *** [3h 8c 8s Th] [5s]
beerjoe984: bets $11
Bula71: calls $11
*** SHOW DOWN ***
beerjoe984: shows [8d 9d] (three of a kind, Eights)
Bula71: mucks hand
beerjoe984 collected $43.25 from pot
*** SUMMARY ***
Total pot $45.25 | Rake $2
Board [3h 8c 8s Th 5s]
Seat 1: beerjoe984 (big blind) showed [8d 9d] and won ($43.25) with three of a kind, Eights
Seat 2: gitarist74 folded before Flop
Seat 3: Bula71 mucked
Seat 4: reginaph folded before Flop (didn't bet)
Seat 5: Sensei2212 (button) folded before Flop (didn't bet)
Seat 6: grandarino (small blind) folded before Flop


PokerStars Hand #208979080344:  Hold'em No Limit ($0.25/$0.50 USD) - 2020/02/08 12:56:42 ET
Table 'Acamar V' 6-max Seat #6 is the button
Seat 1: beerjoe984 ($155.09 in chips)
Seat 3: Bula71 ($53.27 in chips)
Seat 4: reginaph ($63.95 in chips)
Seat 5: Sensei2212 ($50 in chips)
Seat 6: grandarino ($61.89 in chips)
beerjoe984: posts small blind $0.25
gitarist74: is sitting out
Bula71: posts big blind $0.50
*** HOLE CARDS ***
reginaph: raises $0.75 to $1.25
Sensei2212: folds
grandarino: folds
beerjoe984: folds
Bula71: folds
Uncalled bet ($0.75) returned to reginaph
reginaph collected $1.25 from pot
reginaph: doesn't show hand
*** SUMMARY ***
Total pot $1.25 | Rake $0
Seat 1: beerjoe984 (small blind) folded before Flop
Seat 3: Bula71 (big blind) folded before Flop
Seat 4: reginaph collected ($1.25)
Seat 5: Sensei2212 folded before Flop (didn't bet)
Seat 6: grandarino (button) folded before Flop (didn't bet)


PokerStars Hand #208979086664:  Hold'em No Limit ($0.25/$0.50 USD) - 2020/02/08 12:56:56 ET
Table 'Acamar V' 6-max Seat #1 is the button
Seat 1: beerjoe984 ($154.84 in chips)
Seat 3: Bula71 ($52.77 in chips)
Seat 4: reginaph ($64.70 in chips)
Seat 5: Sensei2212 ($50 in chips)
Seat 6: grandarino ($61.89 in chips)
Bula71: posts small blind $0.25
reginaph: posts big blind $0.50
*** HOLE CARDS ***
Sensei2212: folds
grandarino: folds
beerjoe984: raises $0.50 to $1
Bula71: raises $5 to $6
reginaph: folds
beerjoe984: calls $5
*** FLOP *** [5h 7h 2s]
Bula71: bets $8
beerjoe984: calls $8
*** TURN *** [5h 7h 2s] [3c]
Bula71: bets $0.50
beerjoe984: raises $14 to $14.50
Bula71: calls $14
*** RIVER *** [5h 7h 2s 3c] [3s]
Bula71: checks
beerjoe984: bets $27.50
Bula71: folds
Uncalled bet ($27.50) returned to beerjoe984
beerjoe984 collected $55.50 from pot
beerjoe984: doesn't show hand
*** SUMMARY ***
Total pot $57.50 | Rake $2
Board [5h 7h 2s 3c 3s]
Seat 1: beerjoe984 (button) collected ($55.50)
Seat 3: Bula71 (small blind) folded on the River
Seat 4: reginaph (big blind) folded before Flop
Seat 5: Sensei2212 folded before Flop (didn't bet)
Seat 6: grandarino folded before Flop (didn't bet)


PokerStars Hand #208979107735:  Hold'em No Limit ($0.25/$0.50 USD) - 2020/02/08 12:57:45 ET
Table 'Acamar V' 6-max Seat #3 is the button
Seat 1: beerjoe984 ($181.84 in chips)
Seat 3: Bula71 ($50 in chips)
Seat 4: reginaph ($64.20 in chips)
Seat 5: Sensei2212 ($50 in chips)
Seat 6: grandarino ($61.89 in chips)
reginaph: posts small blind $0.25
Sensei2212: posts big blind $0.50
*** HOLE CARDS ***
grandarino: raises $0.75 to $1.25
beerjoe984: folds
Bula71: folds
reginaph: folds
Sensei2212: folds
Uncalled bet ($0.75) returned to grandarino
grandarino collected $1.25 from pot
grandarino: doesn't show hand
*** SUMMARY ***
Total pot $1.25 | Rake $0
Seat 1: beerjoe984 folded before Flop (didn't bet)
Seat 3: Bula71 (button) folded before Flop (didn't bet)
Seat 4: reginaph (small blind) folded before Flop
Seat 5: Sensei2212 (big blind) folded before Flop
Seat 6: grandarino collected ($1.25)


PokerStars Hand #208979119412:  Hold'em No Limit ($0.25/$0.50 USD) - 2020/02/08 12:58:13 ET
Table 'Acamar V' 6-max Seat #4 is the button
Seat 1: beerjoe984 ($181.84 in chips)
Seat 3: Bula71 ($50 in chips)
Seat 4: reginaph ($63.95 in chips)
Seat 5: Sensei2212 ($50 in chips)
Seat 6: grandarino ($62.64 in chips)
Sensei2212: posts small blind $0.25
grandarino: posts big blind $0.50
*** HOLE CARDS ***
beerjoe984: folds
Bula71: raises $0.75 to $1.25
reginaph: folds
Sensei2212: folds
grandarino: folds
Uncalled bet ($0.75) returned to Bula71
Bula71 collected $1.25 from pot
Bula71: doesn't show hand
*** SUMMARY ***
Total pot $1.25 | Rake $0
Seat 1: beerjoe984 folded before Flop (didn't bet)
Seat 3: Bula71 collected ($1.25)
Seat 4: reginaph (button) folded before Flop (didn't bet)
Seat 5: Sensei2212 (small blind) folded before Flop
Seat 6: grandarino (big blind) folded before Flop


PokerStars Hand #208979133626:  Hold'em No Limit ($0.25/$0.50 USD) - 2020/02/08 12:58:46 ET
Table 'Acamar V' 6-max Seat #5 is the button
Seat 1: beerjoe984 ($181.84 in chips)
Seat 3: Bula71 ($50.75 in chips)
Seat 4: reginaph ($63.95 in chips)
Seat 5: Sensei2212 ($50 in chips)
Seat 6: grandarino ($62.14 in chips)
grandarino: posts small blind $0.25
beerjoe984: posts big blind $0.50
*** HOLE CARDS ***
Bula71: folds
reginaph: folds
Sensei2212: folds
grandarino: folds
Uncalled bet ($0.25) returned to beerjoe984
beerjoe984 collected $0.50 from pot
beerjoe984: doesn't show hand
*** SUMMARY ***
Total pot $0.50 | Rake $0
Seat 1: beerjoe984 (big blind) collected ($0.50)
Seat 3: Bula71 folded before Flop (didn't bet)
Seat 4: reginaph folded before Flop (didn't bet)
Seat 5: Sensei2212 (button) folded before Flop (didn't bet)
Seat 6: grandarino (small blind) folded before Flop


PokerStars Hand #208979180215:  Hold'em No Limit ($0.25/$0.50 USD) - 2020/02/08 13:00:33 ET
Table 'Acamar V' 6-max Seat #3 is the button
Seat 2: gitarist74 ($52.31 in chips)
Seat 3: Bula71 ($50.50 in chips)
Seat 4: reginaph ($62.95 in chips)
Seat 5: Sensei2212 ($50 in chips)
Seat 6: grandarino ($61.89 in chips)
reginaph: posts small blind $0.25
Sensei2212: posts big blind $0.50
*** HOLE CARDS ***
grandarino: raises $0.75 to $1.25
gitarist74: folds
Bula71: folds
reginaph: folds
Sensei2212: folds
Uncalled bet ($0.75) returned to grandarino
grandarino collected $1.25 from pot
grandarino: doesn't show hand
*** SUMMARY ***
Total pot $1.25 | Rake $0
Seat 2: gitarist74 folded before Flop (didn't bet)
Seat 3: Bula71 (button) folded before Flop (didn't bet)
Seat 4: reginaph (small blind) folded before Flop
Seat 5: Sensei2212 (big blind) folded before Flop
Seat 6: grandarino collected ($1.25)


PokerStars Hand #208979142623:  Hold'em No Limit ($0.25/$0.50 USD) - 2020/02/08 12:59:07 ET
Table 'Acamar V' 6-max Seat #6 is the button
Seat 1: beerjoe984 ($182.09 in chips)
Seat 2: gitarist74 ($50 in chips)
Seat 3: Bula71 ($50.75 in chips)
Seat 4: reginaph ($63.95 in chips)
Seat 5: Sensei2212 ($50 in chips)
Seat 6: grandarino ($61.89 in chips)
beerjoe984: posts small blind $0.25
gitarist74: posts big blind $0.50
*** HOLE CARDS ***
Bula71: folds
reginaph: raises $0.75 to $1.25
Sensei2212: folds
grandarino: folds
beerjoe984: calls $1
gitarist74: calls $0.75
*** FLOP *** [2s Js 9h]
beerjoe984: checks
gitarist74: checks
reginaph: checks
*** TURN *** [2s Js 9h] [Th]
beerjoe984: checks
gitarist74: checks
reginaph: checks
*** RIVER *** [2s Js 9h Th] [4s]
beerjoe984: checks
gitarist74: bets $3.03
reginaph: folds
beerjoe984: folds
Uncalled bet ($3.03) returned to gitarist74
gitarist74 collected $3.56 from pot
*** SUMMARY ***
Total pot $3.75 | Rake $0.19
Board [2s Js 9h Th 4s]
Seat 1: beerjoe984 (small blind) folded on the River
Seat 2: gitarist74 (big blind) collected ($3.56)
Seat 3: Bula71 folded before Flop (didn't bet)
Seat 4: reginaph folded on the River
Seat 5: Sensei2212 folded before Flop (didn't bet)
Seat 6: grandarino (button) folded before Flop (didn't bet)


PokerStars Hand #208979174520:  Hold'em No Limit ($0.25/$0.50 USD) - 2020/02/08 13:00:20 ET
Table 'Acamar V' 6-max Seat #2 is the button
Seat 2: gitarist74 ($52.31 in chips)
Seat 3: Bula71 ($50.75 in chips)
Seat 4: reginaph ($62.70 in chips)
Seat 5: Sensei2212 ($50 in chips)
Seat 6: grandarino ($61.89 in chips)
Bula71: posts small blind $0.25
reginaph: posts big blind $0.50
*** HOLE CARDS ***
Sensei2212: folds
grandarino: folds
gitarist74: folds
Bula71: folds
Uncalled bet ($0.25) returned to reginaph
reginaph collected $0.50 from pot
reginaph: doesn't show hand
*** SUMMARY ***
Total pot $0.50 | Rake $0
Seat 2: gitarist74 (button) folded before Flop (didn't bet)
Seat 3: Bula71 (small blind) folded before Flop
Seat 4: reginaph (big blind) collected ($0.50)
Seat 5: Sensei2212 folded before Flop (didn't bet)
Seat 6: grandarino folded before Flop (didn't bet)


PokerStars Hand #208979187115:  Hold'em No Limit ($0.25/$0.50 USD) - 2020/02/08 13:00:47 ET
Table 'Acamar V' 6-max Seat #4 is the button
Seat 2: gitarist74 ($52.31 in chips)
Seat 3: Bula71 ($50.50 in chips)
Seat 4: reginaph ($62.70 in chips)
Seat 5: Sensei2212 ($50 in chips)
Seat 6: grandarino ($62.64 in chips)
Sensei2212: posts small blind $0.25
grandarino: posts big blind $0.50
*** HOLE CARDS ***
gitarist74: folds
Bula71: raises $0.75 to $1.25
reginaph: folds
Sensei2212: folds
grandarino: folds
Uncalled bet ($0.75) returned to Bula71
Bula71 collected $1.25 from pot
Bula71: doesn't show hand
*** SUMMARY ***
Total pot $1.25 | Rake $0
Seat 2: gitarist74 folded before Flop (didn't bet)
Seat 3: Bula71 collected ($1.25)
Seat 4: reginaph (button) folded before Flop (didn't bet)
Seat 5: Sensei2212 (small blind) folded before Flop
Seat 6: grandarino (big blind) folded before Flop


PokerStars Hand #208979198844:  Hold'em No Limit ($0.25/$0.50 USD) - 2020/02/08 13:01:12 ET
Table 'Acamar V' 6-max Seat #5 is the button
Seat 2: gitarist74 ($52.31 in chips)
Seat 3: Bula71 ($51.25 in chips)
Seat 4: reginaph ($62.70 in chips)
Seat 5: Sensei2212 ($50 in chips)
gitarist74: posts small blind $0.25
Bula71: posts big blind $0.50
*** HOLE CARDS ***
grandarino leaves the table
reginaph: folds
beerjoe984 leaves the table
Sensei2212: raises $0.60 to $1.10
gitarist74: folds
Bula71: folds
Uncalled bet ($0.60) returned to Sensei2212
Sensei2212 collected $1.25 from pot
Sensei2212: doesn't show hand
*** SUMMARY ***
Total pot $1.25 | Rake $0
Seat 2: gitarist74 (small blind) folded before Flop
Seat 3: Bula71 (big blind) folded before Flop
Seat 4: reginaph folded before Flop (didn't bet)
Seat 5: Sensei2212 (button) collected ($1.25)


PokerStars Hand #208979214213:  Hold'em No Limit ($0.25/$0.50 USD) - 2020/02/08 13:01:24 ET
Table 'Acamar V' 6-max Seat #2 is the button
Seat 2: gitarist74 ($52.06 in chips)
Seat 3: Bula71 ($50.75 in chips)
Seat 5: Sensei2212 ($50.75 in chips)
Bula71: posts small blind $0.25
reginaph: is sitting out
Sensei2212: posts big blind $0.50
*** HOLE CARDS ***
RM-13rus joins the table at seat #6
gitarist74: raises $0.75 to $1.25
reginaph leaves the table
Bula71: raises $3.75 to $5
Sensei2212: folds
gitarist74: folds
Uncalled bet ($3.75) returned to Bula71
Bula71 collected $3 from pot
Bula71: doesn't show hand
*** SUMMARY ***
Total pot $3 | Rake $0
Seat 2: gitarist74 (button) folded before Flop
Seat 3: Bula71 (small blind) collected ($3)
Seat 5: Sensei2212 (big blind) folded before Flop


PokerStars Hand #208979281202:  Hold'em No Limit ($0.25/$0.50 USD) - 2020/02/08 13:03:27 ET
Table 'Acamar V' 6-max Seat #1 is the button
Seat 1: GNicki ($50 in chips)
Seat 2: jackjolley92 ($37.21 in chips)
Seat 3: Faradaay ($50 in chips)
jackjolley92: posts small blind $0.25
Faradaay: posts big blind $0.50
Sensei2212: sits out
ManOnTh3Moon: sits out
*** HOLE CARDS ***
GNicki: folds
jackjolley92: folds
Uncalled bet ($0.25) returned to Faradaay
Faradaay collected $0.50 from pot
Effort92 leaves the table
*** SUMMARY ***
Total pot $0.50 | Rake $0
Seat 1: GNicki (button) folded before Flop (didn't bet)
Seat 2: jackjolley92 (small blind) folded before Flop
Seat 3: Faradaay (big blind) collected ($0.50)


PokerStars Hand #208979285276:  Hold'em No Limit ($0.25/$0.50 USD) - 2020/02/08 13:03:33 ET
Table 'Acamar V' 6-max Seat #2 is the button
Seat 1: GNicki ($50 in chips)
Seat 2: jackjolley92 ($36.96 in chips)
Seat 3: Faradaay ($50.25 in chips)
Seat 5: Sensei2212 ($50.25 in chips)
Faradaay: posts small blind $0.25
Sensei2212: posts big blind $0.50
ManOnTh3Moon: sits out
*** HOLE CARDS ***
GNicki: raises $0.62 to $1.12
jackjolley92: folds
Faradaay: folds
Sensei2212: calls $0.62
*** FLOP *** [Jc 2d 9d]
Sensei2212: bets $1.50
GNicki: folds
Uncalled bet ($1.50) returned to Sensei2212
Sensei2212 collected $2.37 from pot
Sensei2212: doesn't show hand
*** SUMMARY ***
Total pot $2.49 | Rake $0.12
Board [Jc 2d 9d]
Seat 1: GNicki folded on the Flop
Seat 2: jackjolley92 (button) folded before Flop (didn't bet)
Seat 3: Faradaay (small blind) folded before Flop
Seat 5: Sensei2212 (big blind) collected ($2.37)


PokerStars Hand #208979299470:  Hold'em No Limit ($0.25/$0.50 USD) - 2020/02/08 13:03:58 ET
Table 'Acamar V' 6-max Seat #3 is the button
Seat 1: GNicki ($50 in chips)
Seat 2: jackjolley92 ($36.96 in chips)
Seat 3: Faradaay ($50 in chips)
Seat 5: Sensei2212 ($51.50 in chips)
Seat 6: ManOnTh3Moon ($50 in chips)
Sensei2212: posts small blind $0.25
ManOnTh3Moon: posts big blind $0.50
*** HOLE CARDS ***
GNicki: raises $0.62 to $1.12
jackjolley92: folds
Faradaay: folds
Sensei2212: folds
ManOnTh3Moon: calls $0.62
*** FLOP *** [6h 5d 5s]
ManOnTh3Moon: checks
GNicki: bets $1.71
ManOnTh3Moon: folds
Uncalled bet ($1.71) returned to GNicki
GNicki collected $2.37 from pot
GNicki: doesn't show hand
*** SUMMARY ***
Total pot $2.49 | Rake $0.12
Board [6h 5d 5s]
Seat 1: GNicki collected ($2.37)
Seat 2: jackjolley92 folded before Flop (didn't bet)
Seat 3: Faradaay (button) folded before Flop (didn't bet)
Seat 5: Sensei2212 (small blind) folded before Flop
Seat 6: ManOnTh3Moon (big blind) folded on the Flop


PokerStars Hand #208979314868:  Hold'em No Limit ($0.25/$0.50 USD) - 2020/02/08 13:04:26 ET
Table 'Acamar V' 6-max Seat #5 is the button
Seat 1: GNicki ($51.25 in chips)
Seat 2: jackjolley92 ($36.96 in chips)
Seat 3: Faradaay ($50 in chips)
Seat 5: Sensei2212 ($51.25 in chips)
Seat 6: ManOnTh3Moon ($50 in chips)
ManOnTh3Moon: posts small blind $0.25
GNicki: posts big blind $0.50
*** HOLE CARDS ***
jackjolley92: folds
Faradaay: folds
Sensei2212: folds
ManOnTh3Moon: raises $1 to $1.50
GNicki: calls $1
*** FLOP *** [3c 8h Jd]
mizerysage joins the table at seat #4
ManOnTh3Moon: bets $1.03
GNicki: calls $1.03
*** TURN *** [3c 8h Jd] [8d]
ManOnTh3Moon: checks
GNicki: bets $1.54
ManOnTh3Moon: calls $1.54
*** RIVER *** [3c 8h Jd 8d] [7h]
ManOnTh3Moon: checks
GNicki: checks
*** SHOW DOWN ***
ManOnTh3Moon: shows [7s 7c] (a full house, Sevens full of Eights)
GNicki: mucks hand
ManOnTh3Moon collected $7.73 from pot
*** SUMMARY ***
Total pot $8.14 | Rake $0.41
Board [3c 8h Jd 8d 7h]
Seat 1: GNicki (big blind) mucked
Seat 2: jackjolley92 folded before Flop (didn't bet)
Seat 3: Faradaay folded before Flop (didn't bet)
Seat 5: Sensei2212 (button) folded before Flop (didn't bet)
Seat 6: ManOnTh3Moon (small blind) showed [7s 7c] and won ($7.73) with a full house, Sevens full of Eights


PokerStars Hand #208979376477:  Hold'em No Limit ($0.25/$0.50 USD) - 2020/02/08 13:06:13 ET
Table 'Acamar V' 6-max Seat #1 is the button
Seat 1: GNicki ($50 in chips)
Seat 2: jackjolley92 ($73.12 in chips)
Seat 3: Faradaay ($50 in chips)
Seat 5: Sensei2212 ($50 in chips)
Seat 6: ManOnTh3Moon ($53.66 in chips)
jackjolley92: posts small blind $0.25
Faradaay: posts big blind $0.50
mizerysage: sits out
*** HOLE CARDS ***
Sensei2212: folds
ManOnTh3Moon: folds
GNicki: raises $0.62 to $1.12
jackjolley92: calls $0.87
Faradaay: raises $4.67 to $5.79
GNicki: folds
jackjolley92: folds
Uncalled bet ($4.67) returned to Faradaay
Faradaay collected $3.36 from pot
*** SUMMARY ***
Total pot $3.36 | Rake $0
Seat 1: GNicki (button) folded before Flop
Seat 2: jackjolley92 (small blind) folded before Flop
Seat 3: Faradaay (big blind) collected ($3.36)
Seat 5: Sensei2212 folded before Flop (didn't bet)
Seat 6: ManOnTh3Moon folded before Flop (didn't bet)


PokerStars Hand #208979348998:  Hold'em No Limit ($0.25/$0.50 USD) - 2020/02/08 13:05:25 ET
Table 'Acamar V' 6-max Seat #6 is the button
Seat 1: GNicki ($50 in chips)
Seat 2: jackjolley92 ($36.96 in chips)
Seat 3: Faradaay ($50 in chips)
Seat 5: Sensei2212 ($51.25 in chips)
Seat 6: ManOnTh3Moon ($53.66 in chips)
GNicki: posts small blind $0.25
jackjolley92: posts big blind $0.50
mizerysage: sits out
*** HOLE CARDS ***
Faradaay: folds
Sensei2212: raises $0.70 to $1.20
ManOnTh3Moon: folds
GNicki: calls $0.95
jackjolley92: raises $3.60 to $4.80
Sensei2212: raises $46.45 to $51.25 and is all-in
GNicki: folds
jackjolley92: calls $32.16 and is all-in
Uncalled bet ($14.29) returned to Sensei2212
Sensei2212 has timed out
*** FLOP *** [6d Kh Tc]
*** TURN *** [6d Kh Tc] [7c]
*** RIVER *** [6d Kh Tc 7c] [3s]
*** SHOW DOWN ***
jackjolley92: shows [Ac Kc] (a pair of Kings)
Sensei2212: shows [Jd Jc] (a pair of Jacks)
jackjolley92 collected $73.12 from pot
*** SUMMARY ***
Total pot $75.12 | Rake $2
Board [6d Kh Tc 7c 3s]
Seat 1: GNicki (small blind) folded before Flop
Seat 2: jackjolley92 (big blind) showed [Ac Kc] and won ($73.12) with a pair of Kings
Seat 3: Faradaay folded before Flop (didn't bet)
Seat 5: Sensei2212 showed [Jd Jc] and lost with a pair of Jacks
Seat 6: ManOnTh3Moon (button) folded before Flop (didn't bet)


PokerStars Hand #208979393365:  Hold'em No Limit ($0.25/$0.50 USD) - 2020/02/08 13:06:43 ET
Table 'Acamar V' 6-max Seat #2 is the button
Seat 1: GNicki ($50 in chips)
Seat 2: jackjolley92 ($72 in chips)
Seat 3: Faradaay ($52.24 in chips)
Seat 4: mizerysage ($50 in chips)
Seat 5: Sensei2212 ($50 in chips)
Seat 6: ManOnTh3Moon ($53.66 in chips)
Faradaay: posts small blind $0.25
mizerysage: posts big blind $0.50
*** HOLE CARDS ***
Sensei2212: folds
ManOnTh3Moon: folds
GNicki: folds
jackjolley92: calls $0.50
Faradaay: folds
mizerysage: checks
*** FLOP *** [Kc 8d Qd]
mizerysage: checks
jackjolley92: bets $1
mizerysage: folds
Uncalled bet ($1) returned to jackjolley92
jackjolley92 collected $1.19 from pot
jackjolley92: doesn't show hand
*** SUMMARY ***
Total pot $1.25 | Rake $0.06
Board [Kc 8d Qd]
Seat 1: GNicki folded before Flop (didn't bet)
Seat 2: jackjolley92 (button) collected ($1.19)
Seat 3: Faradaay (small blind) folded before Flop
Seat 4: mizerysage (big blind) folded on the Flop
Seat 5: Sensei2212 folded before Flop (didn't bet)
Seat 6: ManOnTh3Moon folded before Flop (didn't bet)


PokerStars Hand #208979403625:  Hold'em No Limit ($0.25/$0.50 USD) - 2020/02/08 13:07:00 ET
Table 'Acamar V' 6-max Seat #3 is the button
Seat 1: GNicki ($50 in chips)
Seat 2: jackjolley92 ($72.69 in chips)
Seat 3: Faradaay ($51.99 in chips)
Seat 4: mizerysage ($50 in chips)
Seat 5: Sensei2212 ($50 in chips)
Seat 6: ManOnTh3Moon ($53.66 in chips)
mizerysage: posts small blind $0.25
Sensei2212: posts big blind $0.50
*** HOLE CARDS ***
ManOnTh3Moon: folds
GNicki: folds
jackjolley92: folds
Faradaay: folds
mizerysage: raises $1 to $1.50
Sensei2212: calls $1
*** FLOP *** [7h 3d 8d]
mizerysage: bets $1.14
Sensei2212: raises $3.36 to $4.50
mizerysage: folds
Uncalled bet ($3.36) returned to Sensei2212
Sensei2212 collected $5.02 from pot
Sensei2212: doesn't show hand
*** SUMMARY ***
Total pot $5.28 | Rake $0.26
Board [7h 3d 8d]
Seat 1: GNicki folded before Flop (didn't bet)
Seat 2: jackjolley92 folded before Flop (didn't bet)
Seat 3: Faradaay (button) folded before Flop (didn't bet)
Seat 4: mizerysage (small blind) folded on the Flop
Seat 5: Sensei2212 (big blind) collected ($5.02)
Seat 6: ManOnTh3Moon folded before Flop (didn't bet)


PokerStars Hand #208979423333:  Hold'em No Limit ($0.25/$0.50 USD) - 2020/02/08 13:07:35 ET
Table 'Acamar V' 6-max Seat #4 is the button
Seat 1: GNicki ($50 in chips)
Seat 2: jackjolley92 ($72.69 in chips)
Seat 3: Faradaay ($51.99 in chips)
Seat 4: mizerysage ($50 in chips)
Seat 5: Sensei2212 ($52.38 in chips)
Seat 6: ManOnTh3Moon ($53.66 in chips)
Sensei2212: posts small blind $0.25
ManOnTh3Moon: posts big blind $0.50
*** HOLE CARDS ***
GNicki: folds
jackjolley92: calls $0.50
Faradaay: folds
mizerysage: folds
Sensei2212: raises $2 to $2.50
ManOnTh3Moon: folds
jackjolley92: calls $2
*** FLOP *** [3d 9c Qc]
Sensei2212: bets $1.72
jackjolley92: raises $3.72 to $5.44
Sensei2212: calls $3.72
*** TURN *** [3d 9c Qc] [5d]
Sensei2212: checks
jackjolley92: bets $7.78
Sensei2212: folds
Uncalled bet ($7.78) returned to jackjolley92
jackjolley92 collected $15.56 from pot
jackjolley92: doesn't show hand
*** SUMMARY ***
Total pot $16.38 | Rake $0.82
Board [3d 9c Qc 5d]
Seat 1: GNicki folded before Flop (didn't bet)
Seat 2: jackjolley92 collected ($15.56)
Seat 3: Faradaay folded before Flop (didn't bet)
Seat 4: mizerysage (button) folded before Flop (didn't bet)
Seat 5: Sensei2212 (small blind) folded on the Turn
Seat 6: ManOnTh3Moon (big blind) folded before Flop


PokerStars Hand #208979446102:  Hold'em No Limit ($0.25/$0.50 USD) - 2020/02/08 13:08:14 ET
Table 'Acamar V' 6-max Seat #5 is the button
Seat 1: GNicki ($50 in chips)
Seat 2: jackjolley92 ($80.31 in chips)
Seat 3: Faradaay ($51.99 in chips)
Seat 4: mizerysage ($50 in chips)
Seat 5: Sensei2212 ($50 in chips)
Seat 6: ManOnTh3Moon ($53.16 in chips)
ManOnTh3Moon: posts small blind $0.25
GNicki: posts big blind $0.50
*** HOLE CARDS ***
jackjolley92: calls $0.50
Faradaay: raises $1.60 to $2.10
mizerysage: folds
Sensei2212: folds
ManOnTh3Moon: folds
GNicki: folds
jackjolley92: folds
Uncalled bet ($1.60) returned to Faradaay
Faradaay collected $1.75 from pot
*** SUMMARY ***
Total pot $1.75 | Rake $0
Seat 1: GNicki (big blind) folded before Flop
Seat 2: jackjolley92 folded before Flop
Seat 3: Faradaay collected ($1.75)
Seat 4: mizerysage folded before Flop (didn't bet)
Seat 5: Sensei2212 (button) folded before Flop (didn't bet)
Seat 6: ManOnTh3Moon (small blind) folded before Flop


PokerStars Hand #208979454887:  Hold'em No Limit ($0.25/$0.50 USD) - 2020/02/08 13:08:29 ET
Table 'Acamar V' 6-max Seat #6 is the button
Seat 1: GNicki ($50 in chips)
Seat 2: jackjolley92 ($79.81 in chips)
Seat 3: Faradaay ($53.24 in chips)
Seat 4: mizerysage ($50 in chips)
Seat 5: Sensei2212 ($50 in chips)
Seat 6: ManOnTh3Moon ($52.91 in chips)
GNicki: posts small blind $0.25
jackjolley92: posts big blind $0.50
*** HOLE CARDS ***
Faradaay: folds
mizerysage: folds
Sensei2212: folds
ManOnTh3Moon: raises $0.60 to $1.10
GNicki: raises $2.40 to $3.50
jackjolley92: folds
ManOnTh3Moon: calls $2.40
*** FLOP *** [Kd 2h 5d]
GNicki: checks
ManOnTh3Moon: checks
*** TURN *** [Kd 2h 5d] [Ts]
GNicki: checks
ManOnTh3Moon: checks
*** RIVER *** [Kd 2h 5d Ts] [5s]
GNicki: checks
ManOnTh3Moon: checks
*** SHOW DOWN ***
GNicki: shows [7s Ah] (a pair of Fives)
ManOnTh3Moon: mucks hand
GNicki collected $7.12 from pot
*** SUMMARY ***
Total pot $7.50 | Rake $0.38
Board [Kd 2h 5d Ts 5s]
Seat 1: GNicki (small blind) showed [7s Ah] and won ($7.12) with a pair of Fives
Seat 2: jackjolley92 (big blind) folded before Flop
Seat 3: Faradaay folded before Flop (didn't bet)
Seat 4: mizerysage folded before Flop (didn't bet)
Seat 5: Sensei2212 folded before Flop (didn't bet)
Seat 6: ManOnTh3Moon (button) mucked


PokerStars Hand #208979493129:  Hold'em No Limit ($0.25/$0.50 USD) - 2020/02/08 13:09:36 ET
Table 'Acamar V' 6-max Seat #1 is the button
Seat 1: GNicki ($53.62 in chips)
Seat 2: jackjolley92 ($79.31 in chips)
Seat 3: Faradaay ($53.24 in chips)
Seat 4: mizerysage ($50 in chips)
Seat 5: Sensei2212 ($50 in chips)
Seat 6: ManOnTh3Moon ($50 in chips)
jackjolley92: posts small blind $0.25
Faradaay: posts big blind $0.50
*** HOLE CARDS ***
mizerysage: raises $0.80 to $1.30
Sensei2212: folds
ManOnTh3Moon: calls $1.30
GNicki: folds
jackjolley92: folds
Faradaay: folds
*** FLOP *** [8s 7h 6s]
mizerysage: checks
ManOnTh3Moon: bets $1.14
mizerysage: calls $1.14
*** TURN *** [8s 7h 6s] [2s]
mizerysage: checks
ManOnTh3Moon: bets $2.94
mizerysage: calls $2.94
*** RIVER *** [8s 7h 6s 2s] [Ac]
mizerysage: checks
ManOnTh3Moon: bets $6.01
mizerysage: calls $6.01
*** SHOW DOWN ***
ManOnTh3Moon: shows [2d 2c] (three of a kind, Deuces)
mizerysage: mucks hand
ManOnTh3Moon collected $22.35 from pot
*** SUMMARY ***
Total pot $23.53 | Rake $1.18
Board [8s 7h 6s 2s Ac]
Seat 1: GNicki (button) folded before Flop (didn't bet)
Seat 2: jackjolley92 (small blind) folded before Flop
Seat 3: Faradaay (big blind) folded before Flop
Seat 4: mizerysage mucked
Seat 5: Sensei2212 folded before Flop (didn't bet)
Seat 6: ManOnTh3Moon showed [2d 2c] and won ($22.35) with three of a kind, Deuces


PokerStars Hand #208979587030:  Hold'em No Limit ($0.25/$0.50 USD) - 2020/02/08 13:12:21 ET
Table 'Acamar V' 6-max Seat #3 is the button
Seat 1: GNicki ($52.12 in chips)
Seat 2: jackjolley92 ($77.56 in chips)
Seat 3: Faradaay ($50 in chips)
Seat 4: mizerysage ($50 in chips)
Seat 5: Sensei2212 ($101.50 in chips)
Seat 6: ManOnTh3Moon ($60.96 in chips)
mizerysage: posts small blind $0.25
Sensei2212: posts big blind $0.50
*** HOLE CARDS ***
ManOnTh3Moon: raises $0.60 to $1.10
GNicki: folds
jackjolley92: folds
Faradaay: folds
mizerysage: folds
Sensei2212: folds
Uncalled bet ($0.60) returned to ManOnTh3Moon
ManOnTh3Moon collected $1.25 from pot
ManOnTh3Moon: doesn't show hand
*** SUMMARY ***
Total pot $1.25 | Rake $0
Seat 1: GNicki folded before Flop (didn't bet)
Seat 2: jackjolley92 folded before Flop (didn't bet)
Seat 3: Faradaay (button) folded before Flop (didn't bet)
Seat 4: mizerysage (small blind) folded before Flop
Seat 5: Sensei2212 (big blind) folded before Flop
Seat 6: ManOnTh3Moon collected ($1.25)


PokerStars Hand #208979535079:  Hold'em No Limit ($0.25/$0.50 USD) - 2020/02/08 13:10:50 ET
Table 'Acamar V' 6-max Seat #2 is the button
Seat 1: GNicki ($53.62 in chips)
Seat 2: jackjolley92 ($79.06 in chips)
Seat 3: Faradaay ($52.74 in chips)
Seat 4: mizerysage ($50 in chips)
Seat 5: Sensei2212 ($50 in chips)
Seat 6: ManOnTh3Moon ($60.96 in chips)
Faradaay: posts small blind $0.25
mizerysage: posts big blind $0.50
*** HOLE CARDS ***
Sensei2212: raises $1 to $1.50
ManOnTh3Moon: folds
GNicki: calls $1.50
jackjolley92: calls $1.50
Faradaay: raises $7.25 to $8.75
mizerysage: folds
Sensei2212: raises $41.25 to $50 and is all-in
GNicki: folds
jackjolley92: folds
Faradaay: calls $41.25
Sensei2212 has timed out
*** FLOP *** [Tc 9d Td]
*** TURN *** [Tc 9d Td] [5s]
*** RIVER *** [Tc 9d Td 5s] [9h]
*** SHOW DOWN ***
Faradaay: shows [Ac Qc] (two pair, Tens and Nines)
Sensei2212: shows [Qh Qd] (two pair, Queens and Tens)
Sensei2212 collected $101.50 from pot
*** SUMMARY ***
Total pot $103.50 | Rake $2
Board [Tc 9d Td 5s 9h]
Seat 1: GNicki folded before Flop
Seat 2: jackjolley92 (button) folded before Flop
Seat 3: Faradaay (small blind) showed [Ac Qc] and lost with two pair, Tens and Nines
Seat 4: mizerysage (big blind) folded before Flop
Seat 5: Sensei2212 showed [Qh Qd] and won ($101.50) with two pair, Queens and Tens
Seat 6: ManOnTh3Moon folded before Flop (didn't bet)


PokerStars Hand #208979628012:  Hold'em No Limit ($0.25/$0.50 USD) - 2020/02/08 13:13:33 ET
Table 'Acamar V' 6-max Seat #6 is the button
Seat 1: GNicki ($52.37 in chips)
Seat 2: jackjolley92 ($77.56 in chips)
Seat 3: Faradaay ($50 in chips)
Seat 4: mizerysage ($50 in chips)
Seat 5: Sensei2212 ($102.80 in chips)
Seat 6: ManOnTh3Moon ($60.96 in chips)
GNicki: posts small blind $0.25
jackjolley92: posts big blind $0.50
*** HOLE CARDS ***
Faradaay: folds
mizerysage: folds
Sensei2212: folds
ManOnTh3Moon: folds
GNicki: folds
Uncalled bet ($0.25) returned to jackjolley92
jackjolley92 collected $0.50 from pot
jackjolley92: doesn't show hand
*** SUMMARY ***
Total pot $0.50 | Rake $0
Seat 1: GNicki (small blind) folded before Flop
Seat 2: jackjolley92 (big blind) collected ($0.50)
Seat 3: Faradaay folded before Flop (didn't bet)
Seat 4: mizerysage folded before Flop (didn't bet)
Seat 5: Sensei2212 folded before Flop (didn't bet)
Seat 6: ManOnTh3Moon (button) folded before Flop (didn't bet)


PokerStars Hand #208979619436:  Hold'em No Limit ($0.25/$0.50 USD) - 2020/02/08 13:13:18 ET
Table 'Acamar V' 6-max Seat #5 is the button
Seat 1: GNicki ($52.87 in chips)
Seat 2: jackjolley92 ($77.56 in chips)
Seat 3: Faradaay ($50 in chips)
Seat 4: mizerysage ($50 in chips)
Seat 5: Sensei2212 ($100.75 in chips)
Seat 6: ManOnTh3Moon ($61.21 in chips)
ManOnTh3Moon: posts small blind $0.25
GNicki: posts big blind $0.50
*** HOLE CARDS ***
jackjolley92: folds
Faradaay: folds
mizerysage: raises $0.80 to $1.30
Sensei2212: raises $3.35 to $4.65
ManOnTh3Moon: folds
GNicki: folds
mizerysage: folds
Uncalled bet ($3.35) returned to Sensei2212
Sensei2212 collected $3.35 from pot
Sensei2212: doesn't show hand
*** SUMMARY ***
Total pot $3.35 | Rake $0
Seat 1: GNicki (big blind) folded before Flop
Seat 2: jackjolley92 folded before Flop (didn't bet)
Seat 3: Faradaay folded before Flop (didn't bet)
Seat 4: mizerysage folded before Flop
Seat 5: Sensei2212 (button) collected ($3.35)
Seat 6: ManOnTh3Moon (small blind) folded before Flop


PokerStars Hand #208979598791:  Hold'em No Limit ($0.25/$0.50 USD) - 2020/02/08 13:12:42 ET
Table 'Acamar V' 6-max Seat #4 is the button
Seat 1: GNicki ($52.12 in chips)
Seat 2: jackjolley92 ($77.56 in chips)
Seat 3: Faradaay ($50 in chips)
Seat 4: mizerysage ($50 in chips)
Seat 5: Sensei2212 ($101 in chips)
Seat 6: ManOnTh3Moon ($61.71 in chips)
Sensei2212: posts small blind $0.25
ManOnTh3Moon: posts big blind $0.50
*** HOLE CARDS ***
GNicki: raises $0.62 to $1.12
jackjolley92: folds
Faradaay: folds
mizerysage: folds
Sensei2212: folds
ManOnTh3Moon: folds
Uncalled bet ($0.62) returned to GNicki
GNicki collected $1.25 from pot
GNicki: doesn't show hand
*** SUMMARY ***
Total pot $1.25 | Rake $0
Seat 1: GNicki collected ($1.25)
Seat 2: jackjolley92 folded before Flop (didn't bet)
Seat 3: Faradaay folded before Flop (didn't bet)
Seat 4: mizerysage (button) folded before Flop (didn't bet)
Seat 5: Sensei2212 (small blind) folded before Flop
Seat 6: ManOnTh3Moon (big blind) folded before Flop


PokerStars Hand #208979632812:  Hold'em No Limit ($0.25/$0.50 USD) - 2020/02/08 13:13:41 ET
Table 'Acamar V' 6-max Seat #1 is the button
Seat 1: GNicki ($52.12 in chips)
Seat 2: jackjolley92 ($77.81 in chips)
Seat 3: Faradaay ($50 in chips)
Seat 4: mizerysage ($50 in chips)
Seat 5: Sensei2212 ($102.80 in chips)
Seat 6: ManOnTh3Moon ($60.96 in chips)
jackjolley92: posts small blind $0.25
Faradaay: posts big blind $0.50
*** HOLE CARDS ***
mizerysage: folds
Sensei2212: folds
ManOnTh3Moon: raises $0.60 to $1.10
GNicki: raises $3.40 to $4.50
jackjolley92: folds
Faradaay: folds
ManOnTh3Moon: calls $3.40
*** FLOP *** [Qd 6d 7h]
ManOnTh3Moon: checks
GNicki: bets $6.50
ManOnTh3Moon: calls $6.50
*** TURN *** [Qd 6d 7h] [5s]
ManOnTh3Moon: checks
GNicki: bets $15.56
ManOnTh3Moon: folds
Uncalled bet ($15.56) returned to GNicki
GNicki collected $21.61 from pot
GNicki: doesn't show hand
*** SUMMARY ***
Total pot $22.75 | Rake $1.14
Board [Qd 6d 7h 5s]
Seat 1: GNicki (button) collected ($21.61)
Seat 2: jackjolley92 (small blind) folded before Flop
Seat 3: Faradaay (big blind) folded before Flop
Seat 4: mizerysage folded before Flop (didn't bet)
Seat 5: Sensei2212 folded before Flop (didn't bet)
Seat 6: ManOnTh3Moon folded on the Turn


PokerStars Hand #208979686056:  Hold'em No Limit ($0.25/$0.50 USD) - 2020/02/08 13:15:14 ET
Table 'Acamar V' 6-max Seat #3 is the button
Seat 1: GNicki ($62.73 in chips)
Seat 2: jackjolley92 ($74.56 in chips)
Seat 3: Faradaay ($50 in chips)
Seat 4: mizerysage ($52.94 in chips)
Seat 5: Sensei2212 ($102.80 in chips)
Seat 6: ManOnTh3Moon ($50 in chips)
mizerysage: posts small blind $0.25
Sensei2212: posts big blind $0.50
*** HOLE CARDS ***
ManOnTh3Moon: folds
GNicki: raises $0.62 to $1.12
jackjolley92: folds
Faradaay: folds
mizerysage: folds
Sensei2212: folds
Uncalled bet ($0.62) returned to GNicki
GNicki collected $1.25 from pot
GNicki: doesn't show hand
*** SUMMARY ***
Total pot $1.25 | Rake $0
Seat 1: GNicki collected ($1.25)
Seat 2: jackjolley92 folded before Flop (didn't bet)
Seat 3: Faradaay (button) folded before Flop (didn't bet)
Seat 4: mizerysage (small blind) folded before Flop
Seat 5: Sensei2212 (big blind) folded before Flop
Seat 6: ManOnTh3Moon folded before Flop (didn't bet)


PokerStars Hand #208979666427:  Hold'em No Limit ($0.25/$0.50 USD) - 2020/02/08 13:14:41 ET
Table 'Acamar V' 6-max Seat #2 is the button
Seat 1: GNicki ($62.73 in chips)
Seat 2: jackjolley92 ($77.56 in chips)
Seat 3: Faradaay ($50 in chips)
Seat 4: mizerysage ($50 in chips)
Seat 5: Sensei2212 ($102.80 in chips)
Seat 6: ManOnTh3Moon ($50 in chips)
Faradaay: posts small blind $0.25
mizerysage: posts big blind $0.50
*** HOLE CARDS ***
Sensei2212: folds
ManOnTh3Moon: folds
GNicki: folds
jackjolley92: raises $1 to $1.50
Faradaay: folds
mizerysage: calls $1
*** FLOP *** [2c 9d 9s]
mizerysage: checks
jackjolley92: bets $1.50
mizerysage: calls $1.50
*** TURN *** [2c 9d 9s] [3h]
mizerysage: checks
jackjolley92: checks
*** RIVER *** [2c 9d 9s 3h] [Jh]
mizerysage: checks
jackjolley92: checks
*** SHOW DOWN ***
mizerysage: shows [2d Qd] (two pair, Nines and Deuces)
jackjolley92: mucks hand
mizerysage collected $5.94 from pot
*** SUMMARY ***
Total pot $6.25 | Rake $0.31
Board [2c 9d 9s 3h Jh]
Seat 1: GNicki folded before Flop (didn't bet)
Seat 2: jackjolley92 (button) mucked
Seat 3: Faradaay (small blind) folded before Flop
Seat 4: mizerysage (big blind) showed [2d Qd] and won ($5.94) with two pair, Nines and Deuces
Seat 5: Sensei2212 folded before Flop (didn't bet)
Seat 6: ManOnTh3Moon folded before Flop (didn't bet)


PokerStars Hand #208979697760:  Hold'em No Limit ($0.25/$0.50 USD) - 2020/02/08 13:15:34 ET
Table 'Acamar V' 6-max Seat #4 is the button
Seat 1: GNicki ($63.48 in chips)
Seat 2: jackjolley92 ($74.56 in chips)
Seat 3: Faradaay ($50 in chips)
Seat 4: mizerysage ($52.69 in chips)
Seat 5: Sensei2212 ($102.30 in chips)
Seat 6: ManOnTh3Moon ($50 in chips)
Sensei2212: posts small blind $0.25
ManOnTh3Moon: posts big blind $0.50
*** HOLE CARDS ***
GNicki: folds
jackjolley92: calls $0.50
Faradaay: raises $1.10 to $1.60
mizerysage: folds
Sensei2212: folds
ManOnTh3Moon: calls $1.10
jackjolley92: calls $1.10
*** FLOP *** [Ac 3c 5c]
ManOnTh3Moon: checks
jackjolley92: checks
Faradaay: bets $1.58
ManOnTh3Moon: calls $1.58
jackjolley92: raises $4.58 to $6.16
Faradaay: calls $4.58
ManOnTh3Moon: folds
*** TURN *** [Ac 3c 5c] [6d]
jackjolley92: bets $7.50
Faradaay: calls $7.50
*** RIVER *** [Ac 3c 5c 6d] [6c]
jackjolley92: bets $8.50
Faradaay: calls $8.50
*** SHOW DOWN ***
jackjolley92: shows [5d 3d] (two pair, Sixes and Fives)
Faradaay: shows [4d 4c] (a flush, Ace high)
Faradaay collected $48.95 from pot
*** SUMMARY ***
Total pot $50.95 | Rake $2
Board [Ac 3c 5c 6d 6c]
Seat 1: GNicki folded before Flop (didn't bet)
Seat 2: jackjolley92 showed [5d 3d] and lost with two pair, Sixes and Fives
Seat 3: Faradaay showed [4d 4c] and won ($48.95) with a flush, Ace high
Seat 4: mizerysage (button) folded before Flop (didn't bet)
Seat 5: Sensei2212 (small blind) folded before Flop
Seat 6: ManOnTh3Moon (big blind) folded on the Flop


PokerStars Hand #208979760677:  Hold'em No Limit ($0.25/$0.50 USD) - 2020/02/08 13:17:17 ET
Table 'Acamar V' 6-max Seat #5 is the button
Seat 1: GNicki ($63.48 in chips)
Seat 2: jackjolley92 ($50.80 in chips)
Seat 3: Faradaay ($75.19 in chips)
Seat 4: mizerysage ($52.69 in chips)
Seat 5: Sensei2212 ($102.05 in chips)
Seat 6: ManOnTh3Moon ($50 in chips)
ManOnTh3Moon: posts small blind $0.25
GNicki: posts big blind $0.50
*** HOLE CARDS ***
jackjolley92: raises $0.50 to $1
Faradaay: folds
mizerysage: raises $2.50 to $3.50
Sensei2212: folds
ManOnTh3Moon: folds
GNicki: folds
jackjolley92: calls $2.50
*** FLOP *** [Td Kh Qd]
jackjolley92: checks
mizerysage: checks
*** TURN *** [Td Kh Qd] [3s]
jackjolley92: checks
mizerysage: checks
*** RIVER *** [Td Kh Qd 3s] [5s]
jackjolley92: bets $7
mizerysage: calls $7
*** SHOW DOWN ***
jackjolley92: shows [Ts Ks] (two pair, Kings and Tens)
mizerysage: mucks hand
jackjolley92 collected $20.66 from pot
*** SUMMARY ***
Total pot $21.75 | Rake $1.09
Board [Td Kh Qd 3s 5s]
Seat 1: GNicki (big blind) folded before Flop
Seat 2: jackjolley92 showed [Ts Ks] and won ($20.66) with two pair, Kings and Tens
Seat 3: Faradaay folded before Flop (didn't bet)
Seat 4: mizerysage mucked
Seat 5: Sensei2212 (button) folded before Flop (didn't bet)
Seat 6: ManOnTh3Moon (small blind) folded before Flop


PokerStars Hand #208979785775:  Hold'em No Limit ($0.25/$0.50 USD) - 2020/02/08 13:17:58 ET
Table 'Acamar V' 6-max Seat #6 is the button
Seat 1: GNicki ($62.98 in chips)
Seat 2: jackjolley92 ($60.96 in chips)
Seat 3: Faradaay ($75.19 in chips)
Seat 4: mizerysage ($50 in chips)
Seat 5: Sensei2212 ($102.05 in chips)
Seat 6: ManOnTh3Moon ($50 in chips)
GNicki: posts small blind $0.25
jackjolley92: posts big blind $0.50
*** HOLE CARDS ***
Faradaay: folds
mizerysage: folds
Sensei2212: folds
ManOnTh3Moon: raises $0.60 to $1.10
GNicki: calls $0.85
jackjolley92: calls $0.60
*** FLOP *** [3d 2c 9s]
GNicki: checks
jackjolley92: bets $1
ManOnTh3Moon: raises $2.57 to $3.57
GNicki: calls $3.57
jackjolley92: folds
*** TURN *** [3d 2c 9s] [6c]
GNicki: checks
ManOnTh3Moon: checks
*** RIVER *** [3d 2c 9s 6c] [4h]
GNicki: bets $8.50
ManOnTh3Moon: folds
Uncalled bet ($8.50) returned to GNicki
GNicki collected $10.87 from pot
GNicki: doesn't show hand
*** SUMMARY ***
Total pot $11.44 | Rake $0.57
Board [3d 2c 9s 6c 4h]
Seat 1: GNicki (small blind) collected ($10.87)
Seat 2: jackjolley92 (big blind) folded on the Flop
Seat 3: Faradaay folded before Flop (didn't bet)
Seat 4: mizerysage folded before Flop (didn't bet)
Seat 5: Sensei2212 folded before Flop (didn't bet)
Seat 6: ManOnTh3Moon (button) folded on the River


PokerStars Hand #208979864578:  Hold'em No Limit ($0.25/$0.50 USD) - 2020/02/08 13:20:06 ET
Table 'Acamar V' 6-max Seat #2 is the button
Seat 1: GNicki ($69.18 in chips)
Seat 2: jackjolley92 ($48.86 in chips)
Seat 3: Faradaay ($84.19 in chips)
Seat 4: mizerysage ($50 in chips)
Seat 5: Sensei2212 ($102.05 in chips)
Seat 6: ManOnTh3Moon ($50 in chips)
Faradaay: posts small blind $0.25
mizerysage: posts big blind $0.50
*** HOLE CARDS ***
Sensei2212: folds
ManOnTh3Moon: folds
GNicki: folds
jackjolley92: calls $0.50
Faradaay: calls $0.25
mizerysage: raises $2.50 to $3
jackjolley92: folds
Faradaay: folds
Uncalled bet ($2.50) returned to mizerysage
mizerysage collected $1.50 from pot
mizerysage: doesn't show hand
*** SUMMARY ***
Total pot $1.50 | Rake $0
Seat 1: GNicki folded before Flop (didn't bet)
Seat 2: jackjolley92 (button) folded before Flop
Seat 3: Faradaay (small blind) folded before Flop
Seat 4: mizerysage (big blind) collected ($1.50)
Seat 5: Sensei2212 folded before Flop (didn't bet)
Seat 6: ManOnTh3Moon folded before Flop (didn't bet)


PokerStars Hand #208979819600:  Hold'em No Limit ($0.25/$0.50 USD) - 2020/02/08 13:18:53 ET
Table 'Acamar V' 6-max Seat #1 is the button
Seat 1: GNicki ($69.18 in chips)
Seat 2: jackjolley92 ($58.86 in chips)
Seat 3: Faradaay ($75.19 in chips)
Seat 4: mizerysage ($50 in chips)
Seat 5: Sensei2212 ($102.05 in chips)
Seat 6: ManOnTh3Moon ($50 in chips)
jackjolley92: posts small blind $0.25
Faradaay: posts big blind $0.50
*** HOLE CARDS ***
mizerysage: folds
Sensei2212: folds
ManOnTh3Moon: folds
GNicki: folds
jackjolley92: calls $0.25
Faradaay: raises $1.50 to $2
jackjolley92: calls $1.50
*** FLOP *** [9h 6d 5d]
jackjolley92: bets $1
Faradaay: raises $2.50 to $3.50
jackjolley92: calls $2.50
*** TURN *** [9h 6d 5d] [As]
jackjolley92: bets $4.50
Faradaay: raises $11.75 to $16.25
jackjolley92: folds
Uncalled bet ($11.75) returned to Faradaay
Faradaay collected $19 from pot
*** SUMMARY ***
Total pot $20 | Rake $1
Board [9h 6d 5d As]
Seat 1: GNicki (button) folded before Flop (didn't bet)
Seat 2: jackjolley92 (small blind) folded on the Turn
Seat 3: Faradaay (big blind) collected ($19)
Seat 4: mizerysage folded before Flop (didn't bet)
Seat 5: Sensei2212 folded before Flop (didn't bet)
Seat 6: ManOnTh3Moon folded before Flop (didn't bet)


PokerStars Hand #208979904265:  Hold'em No Limit ($0.25/$0.50 USD) - 2020/02/08 13:21:00 ET
Table 'Acamar V' 6-max Seat #4 is the button
Seat 1: GNicki ($69.18 in chips)
Seat 2: jackjolley92 ($48.36 in chips)
Seat 3: Faradaay ($83.69 in chips)
Seat 4: mizerysage ($50.75 in chips)
Seat 5: Sensei2212 ($102.30 in chips)
Seat 6: ManOnTh3Moon ($50 in chips)
Sensei2212: posts small blind $0.25
ManOnTh3Moon: posts big blind $0.50
*** HOLE CARDS ***
GNicki: folds
jackjolley92: calls $0.50
Faradaay: folds
mizerysage: raises $2 to $2.50
Sensei2212: raises $6 to $8.50
ManOnTh3Moon: folds
jackjolley92: folds
mizerysage: raises $42.25 to $50.75 and is all-in
Sensei2212: folds
Uncalled bet ($42.25) returned to mizerysage
mizerysage collected $18 from pot
mizerysage: doesn't show hand
*** SUMMARY ***
Total pot $18 | Rake $0
Seat 1: GNicki folded before Flop (didn't bet)
Seat 2: jackjolley92 folded before Flop
Seat 3: Faradaay folded before Flop (didn't bet)
Seat 4: mizerysage (button) collected ($18)
Seat 5: Sensei2212 (small blind) folded before Flop
Seat 6: ManOnTh3Moon (big blind) folded before Flop


PokerStars Hand #208979890427:  Hold'em No Limit ($0.25/$0.50 USD) - 2020/02/08 13:20:38 ET
Table 'Acamar V' 6-max Seat #3 is the button
Seat 1: GNicki ($69.18 in chips)
Seat 2: jackjolley92 ($48.36 in chips)
Seat 3: Faradaay ($83.69 in chips)
Seat 4: mizerysage ($51 in chips)
Seat 5: Sensei2212 ($102.05 in chips)
Seat 6: ManOnTh3Moon ($50 in chips)
mizerysage: posts small blind $0.25
Sensei2212: posts big blind $0.50
*** HOLE CARDS ***
ManOnTh3Moon: folds
GNicki: folds
jackjolley92 has timed out
jackjolley92: folds
Faradaay: folds
mizerysage: folds
Uncalled bet ($0.25) returned to Sensei2212
Sensei2212 collected $0.50 from pot
Sensei2212: doesn't show hand
*** SUMMARY ***
Total pot $0.50 | Rake $0
Seat 1: GNicki folded before Flop (didn't bet)
Seat 2: jackjolley92 folded before Flop (didn't bet)
Seat 3: Faradaay (button) folded before Flop (didn't bet)
Seat 4: mizerysage (small blind) folded before Flop
Seat 5: Sensei2212 (big blind) collected ($0.50)
Seat 6: ManOnTh3Moon folded before Flop (didn't bet)


PokerStars Hand #208979932345:  Hold'em No Limit ($0.25/$0.50 USD) - 2020/02/08 13:21:44 ET
Table 'Acamar V' 6-max Seat #5 is the button
Seat 1: GNicki ($69.18 in chips)
Seat 2: jackjolley92 ($47.86 in chips)
Seat 3: Faradaay ($83.69 in chips)
Seat 4: mizerysage ($60.25 in chips)
Seat 5: Sensei2212 ($93.80 in chips)
Seat 6: ManOnTh3Moon ($50 in chips)
ManOnTh3Moon: posts small blind $0.25
GNicki: posts big blind $0.50
*** HOLE CARDS ***
jackjolley92: calls $0.50
Faradaay: folds
mizerysage: folds
Sensei2212: raises $1.50 to $2
ManOnTh3Moon: folds
GNicki: folds
jackjolley92: calls $1.50
*** FLOP *** [8h Js Qs]
jackjolley92: checks
Sensei2212: checks
*** TURN *** [8h Js Qs] [Th]
jackjolley92: bets $1.50
Sensei2212: calls $1.50
*** RIVER *** [8h Js Qs Th] [7h]
jackjolley92: checks
Sensei2212: checks
*** SHOW DOWN ***
jackjolley92: shows [Ad 6c] (high card Ace)
Sensei2212: shows [Kd Jh] (a pair of Jacks)
Sensei2212 collected $7.36 from pot
*** SUMMARY ***
Total pot $7.75 | Rake $0.39
Board [8h Js Qs Th 7h]
Seat 1: GNicki (big blind) folded before Flop
Seat 2: jackjolley92 showed [Ad 6c] and lost with high card Ace
Seat 3: Faradaay folded before Flop (didn't bet)
Seat 4: mizerysage folded before Flop (didn't bet)
Seat 5: Sensei2212 (button) showed [Kd Jh] and won ($7.36) with a pair of Jacks
Seat 6: ManOnTh3Moon (small blind) folded before Flop


PokerStars Hand #208979965038:  Hold'em No Limit ($0.25/$0.50 USD) - 2020/02/08 13:22:37 ET
Table 'Acamar V' 6-max Seat #6 is the button
Seat 1: GNicki ($68.68 in chips)
Seat 2: jackjolley92 ($44.36 in chips)
Seat 3: Faradaay ($83.69 in chips)
Seat 4: mizerysage ($60.25 in chips)
Seat 5: Sensei2212 ($97.66 in chips)
Seat 6: ManOnTh3Moon ($50 in chips)
GNicki: posts small blind $0.25
jackjolley92: posts big blind $0.50
*** HOLE CARDS ***
Faradaay: folds
mizerysage: folds
Sensei2212: folds
ManOnTh3Moon: folds
GNicki: raises $0.62 to $1.12
jackjolley92: calls $0.62
*** FLOP *** [8c Kd Ah]
GNicki: bets $1.12
jackjolley92: calls $1.12
*** TURN *** [8c Kd Ah] [Ad]
GNicki: checks
jackjolley92: bets $2.13
GNicki: calls $2.13
*** RIVER *** [8c Kd Ah Ad] [Qs]
GNicki: checks
jackjolley92: bets $4.15
GNicki: folds
Uncalled bet ($4.15) returned to jackjolley92
jackjolley92 collected $8.30 from pot
jackjolley92: doesn't show hand
*** SUMMARY ***
Total pot $8.74 | Rake $0.44
Board [8c Kd Ah Ad Qs]
Seat 1: GNicki (small blind) folded on the River
Seat 2: jackjolley92 (big blind) collected ($8.30)
Seat 3: Faradaay folded before Flop (didn't bet)
Seat 4: mizerysage folded before Flop (didn't bet)
Seat 5: Sensei2212 folded before Flop (didn't bet)
Seat 6: ManOnTh3Moon (button) folded before Flop (didn't bet)


PokerStars Hand #208980017619:  Hold'em No Limit ($0.25/$0.50 USD) - 2020/02/08 13:24:01 ET
Table 'Acamar V' 6-max Seat #3 is the button
Seat 1: GNicki ($64.31 in chips)
Seat 2: jackjolley92 ($48.79 in chips)
Seat 3: Faradaay ($82.94 in chips)
Seat 4: mizerysage ($59.75 in chips)
Seat 5: Sensei2212 ($98.41 in chips)
mizerysage: posts small blind $0.25
Sensei2212: posts big blind $0.50
*** HOLE CARDS ***
GNicki: raises $0.62 to $1.12
jackjolley92: folds
Faradaay: folds
mizerysage: folds
Sensei2212: folds
Uncalled bet ($0.62) returned to GNicki
grandarino leaves the table
GNicki collected $1.25 from pot
GNicki: doesn't show hand
*** SUMMARY ***
Total pot $1.25 | Rake $0
Seat 1: GNicki collected ($1.25)
Seat 2: jackjolley92 folded before Flop (didn't bet)
Seat 3: Faradaay (button) folded before Flop (didn't bet)
Seat 4: mizerysage (small blind) folded before Flop
Seat 5: Sensei2212 (big blind) folded before Flop


PokerStars Hand #208979988840:  Hold'em No Limit ($0.25/$0.50 USD) - 2020/02/08 13:23:15 ET
Table 'Acamar V' 6-max Seat #1 is the button
Seat 1: GNicki ($64.31 in chips)
Seat 2: jackjolley92 ($48.29 in chips)
Seat 3: Faradaay ($83.69 in chips)
Seat 4: mizerysage ($60.25 in chips)
Seat 5: Sensei2212 ($97.66 in chips)
Seat 6: ManOnTh3Moon ($50 in chips)
jackjolley92: posts small blind $0.25
Faradaay: posts big blind $0.50
*** HOLE CARDS ***
mizerysage: folds
Sensei2212: raises $1 to $1.50
ManOnTh3Moon: folds
GNicki: folds
jackjolley92: folds
Faradaay: folds
Uncalled bet ($1) returned to Sensei2212
Sensei2212 collected $1.25 from pot
Sensei2212: doesn't show hand
*** SUMMARY ***
Total pot $1.25 | Rake $0
Seat 1: GNicki (button) folded before Flop (didn't bet)
Seat 2: jackjolley92 (small blind) folded before Flop
Seat 3: Faradaay (big blind) folded before Flop
Seat 4: mizerysage folded before Flop (didn't bet)
Seat 5: Sensei2212 collected ($1.25)
Seat 6: ManOnTh3Moon folded before Flop (didn't bet)


PokerStars Hand #208980003912:  Hold'em No Limit ($0.25/$0.50 USD) - 2020/02/08 13:23:39 ET
Table 'Acamar V' 6-max Seat #2 is the button
Seat 1: GNicki ($64.31 in chips)
Seat 2: jackjolley92 ($48.04 in chips)
Seat 3: Faradaay ($83.19 in chips)
Seat 4: mizerysage ($60.25 in chips)
Seat 5: Sensei2212 ($98.41 in chips)
Seat 6: ManOnTh3Moon ($50 in chips)
Faradaay: posts small blind $0.25
mizerysage: posts big blind $0.50
*** HOLE CARDS ***
Sensei2212: folds
ManOnTh3Moon: folds
GNicki: folds
jackjolley92: raises $2 to $2.50
ManOnTh3Moon leaves the table
Faradaay: folds
mizerysage: folds
Uncalled bet ($2) returned to jackjolley92
jackjolley92 collected $1.25 from pot
jackjolley92: doesn't show hand
grandarino joins the table at seat #6
*** SUMMARY ***
Total pot $1.25 | Rake $0
Seat 1: GNicki folded before Flop (didn't bet)
Seat 2: jackjolley92 (button) collected ($1.25)
Seat 3: Faradaay (small blind) folded before Flop
Seat 4: mizerysage (big blind) folded before Flop
Seat 5: Sensei2212 folded before Flop (didn't bet)
Seat 6: ManOnTh3Moon folded before Flop (didn't bet)


PokerStars Hand #208980027606:  Hold'em No Limit ($0.25/$0.50 USD) - 2020/02/08 13:24:17 ET
Table 'Acamar V' 6-max Seat #4 is the button
Seat 1: GNicki ($65.06 in chips)
Seat 2: jackjolley92 ($48.79 in chips)
Seat 3: Faradaay ($82.94 in chips)
Seat 4: mizerysage ($59.50 in chips)
Seat 5: Sensei2212 ($97.91 in chips)
Sensei2212: posts small blind $0.25
GNicki: posts big blind $0.50
*** HOLE CARDS ***
jackjolley92: calls $0.50
Faradaay: folds
mizerysage: raises $1.50 to $2
Sensei2212: raises $5 to $7
GNicki: folds
jackjolley92: folds
mizerysage: folds
Uncalled bet ($5) returned to Sensei2212
Sensei2212 collected $5 from pot
Sensei2212: doesn't show hand
*** SUMMARY ***
Total pot $5 | Rake $0
Seat 1: GNicki (big blind) folded before Flop
Seat 2: jackjolley92 folded before Flop
Seat 3: Faradaay folded before Flop (didn't bet)
Seat 4: mizerysage (button) folded before Flop
Seat 5: Sensei2212 (small blind) collected ($5)


PokerStars Hand #208980044492:  Hold'em No Limit ($0.25/$0.50 USD) - 2020/02/08 13:24:45 ET
Table 'Acamar V' 6-max Seat #5 is the button
Seat 1: GNicki ($64.56 in chips)
Seat 2: jackjolley92 ($48.29 in chips)
Seat 3: Faradaay ($82.94 in chips)
Seat 4: mizerysage ($57.50 in chips)
Seat 5: Sensei2212 ($100.91 in chips)
GNicki: posts small blind $0.25
jackjolley92: posts big blind $0.50
*** HOLE CARDS ***
Faradaay: folds
mizerysage: raises $0.80 to $1.30
Sensei2212: folds
GNicki: folds
jackjolley92: calls $0.80
*** FLOP *** [Qs Qd Qc]
jackjolley92: bets $0.50
mizerysage: calls $0.50
*** TURN *** [Qs Qd Qc] [Ts]
fandorin2005 joins the table at seat #6
jackjolley92: bets $0.50
mizerysage: folds
Uncalled bet ($0.50) returned to jackjolley92
jackjolley92 collected $3.66 from pot
jackjolley92: doesn't show hand
*** SUMMARY ***
Total pot $3.85 | Rake $0.19
Board [Qs Qd Qc Ts]
Seat 1: GNicki (small blind) folded before Flop
Seat 2: jackjolley92 (big blind) collected ($3.66)
Seat 3: Faradaay folded before Flop (didn't bet)
Seat 4: mizerysage folded on the Turn
Seat 5: Sensei2212 (button) folded before Flop (didn't bet)


PokerStars Hand #208980068480:  Hold'em No Limit ($0.25/$0.50 USD) - 2020/02/08 13:25:23 ET
Table 'Acamar V' 6-max Seat #1 is the button
Seat 1: GNicki ($64.31 in chips)
Seat 2: jackjolley92 ($50.15 in chips)
Seat 3: Faradaay ($82.94 in chips)
Seat 4: mizerysage ($55.70 in chips)
Seat 5: Sensei2212 ($100.91 in chips)
jackjolley92: posts small blind $0.25
Faradaay: posts big blind $0.50
fandorin2005: sits out
*** HOLE CARDS ***
mizerysage: raises $0.80 to $1.30
Sensei2212: folds
GNicki: folds
jackjolley92: calls $1.05
Faradaay: folds
*** FLOP *** [6d Jc 7h]
jackjolley92: checks
mizerysage: bets $1.18
jackjolley92: calls $1.18
*** TURN *** [6d Jc 7h] [Js]
jackjolley92: bets $0.50
mizerysage: raises $4.50 to $5
jackjolley92: folds
Uncalled bet ($4.50) returned to mizerysage
mizerysage collected $6.14 from pot
mizerysage: doesn't show hand
*** SUMMARY ***
Total pot $6.46 | Rake $0.32
Board [6d Jc 7h Js]
Seat 1: GNicki (button) folded before Flop (didn't bet)
Seat 2: jackjolley92 (small blind) folded on the Turn
Seat 3: Faradaay (big blind) folded before Flop
Seat 4: mizerysage collected ($6.14)
Seat 5: Sensei2212 folded before Flop (didn't bet)


PokerStars Hand #208980092757:  Hold'em No Limit ($0.25/$0.50 USD) - 2020/02/08 13:26:02 ET
Table 'Acamar V' 6-max Seat #2 is the button
Seat 1: GNicki ($64.31 in chips)
Seat 2: jackjolley92 ($47.17 in chips)
Seat 3: Faradaay ($82.44 in chips)
Seat 4: mizerysage ($58.86 in chips)
Seat 5: Sensei2212 ($100.91 in chips)
Faradaay: posts small blind $0.25
mizerysage: posts big blind $0.50
fandorin2005: sits out
*** HOLE CARDS ***
Sensei2212: folds
GNicki: folds
jackjolley92: raises $1.50 to $2
Faradaay: raises $5 to $7
mizerysage: folds
jackjolley92: raises $40.17 to $47.17 and is all-in
Faradaay: calls $40.17
*** FLOP *** [8h Qc 9d]
*** TURN *** [8h Qc 9d] [As]
*** RIVER *** [8h Qc 9d As] [3d]
*** SHOW DOWN ***
Faradaay: shows [Jd Jc] (a pair of Jacks)
jackjolley92: shows [7h 7d] (a pair of Sevens)
Faradaay collected $92.84 from pot
*** SUMMARY ***
Total pot $94.84 | Rake $2
Board [8h Qc 9d As 3d]
Seat 1: GNicki folded before Flop (didn't bet)
Seat 2: jackjolley92 (button) showed [7h 7d] and lost with a pair of Sevens
Seat 3: Faradaay (small blind) showed [Jd Jc] and won ($92.84) with a pair of Jacks
Seat 4: mizerysage (big blind) folded before Flop
Seat 5: Sensei2212 folded before Flop (didn't bet)


PokerStars Hand #208980133634:  Hold'em No Limit ($0.25/$0.50 USD) - 2020/02/08 13:27:06 ET
Table 'Acamar V' 6-max Seat #3 is the button
Seat 1: GNicki ($64.31 in chips)
Seat 3: Faradaay ($128.11 in chips)
Seat 4: mizerysage ($58.36 in chips)
Seat 5: Sensei2212 ($100.91 in chips)
mizerysage: posts small blind $0.25
Sensei2212: posts big blind $0.50
fandorin2005: sits out
*** HOLE CARDS ***
GNicki: folds
Faradaay: folds
mizerysage: raises $1 to $1.50
Sensei2212: calls $1
*** FLOP *** [8s 6h 2c]
mizerysage: checks
Sensei2212: bets $1.57
mizerysage: raises $3.43 to $5
jackjolley92 is disconnected
Sensei2212: folds
Uncalled bet ($3.43) returned to mizerysage
mizerysage collected $5.83 from pot
mizerysage: doesn't show hand
*** SUMMARY ***
Total pot $6.14 | Rake $0.31
Board [8s 6h 2c]
Seat 1: GNicki folded before Flop (didn't bet)
Seat 3: Faradaay (button) folded before Flop (didn't bet)
Seat 4: mizerysage (small blind) collected ($5.83)
Seat 5: Sensei2212 (big blind) folded on the Flop


PokerStars Hand #208980154033:  Hold'em No Limit ($0.25/$0.50 USD) - 2020/02/08 13:27:39 ET
Table 'Acamar V' 6-max Seat #4 is the button
Seat 1: GNicki ($64.31 in chips)
Seat 3: Faradaay ($128.11 in chips)
Seat 4: mizerysage ($61.12 in chips)
Seat 5: Sensei2212 ($97.84 in chips)
Sensei2212: posts small blind $0.25
GNicki: posts big blind $0.50
*** HOLE CARDS ***
Faradaay: folds
mizerysage: raises $0.60 to $1.10
Sensei2212: raises $3.40 to $4.50
GNicki: calls $4
fandorin2005 leaves the table
mizerysage: calls $3.40
*** FLOP *** [Kd 5c Ks]
Rezzonner joins the table at seat #6
Rezzonner leaves the table
!MrChiigurh joins the table at seat #6
Sensei2212: bets $4.23
GNicki: calls $4.23
!MrChiigurh leaves the table
mizerysage: folds
*** TURN *** [Kd 5c Ks] [4s]
Sensei2212: checks
GNicki: checks
*** RIVER *** [Kd 5c Ks 4s] [Ts]
Sensei2212: checks
GNicki: checks
*** SHOW DOWN ***
Sensei2212: shows [7c Ac] (a pair of Kings)
GNicki: shows [6h 6d] (two pair, Kings and Sixes)
GNicki collected $21.21 from pot
*** SUMMARY ***
Total pot $21.96 | Rake $0.75
Board [Kd 5c Ks 4s Ts]
Seat 1: GNicki (big blind) showed [6h 6d] and won ($21.21) with two pair, Kings and Sixes
Seat 3: Faradaay folded before Flop (didn't bet)
Seat 4: mizerysage (button) folded on the Flop
Seat 5: Sensei2212 (small blind) showed [7c Ac] and lost with a pair of Kings


PokerStars Hand #208980203591:  Hold'em No Limit ($0.25/$0.50 USD) - 2020/02/08 13:28:58 ET
Table 'Acamar V' 6-max Seat #5 is the button
Seat 1: GNicki ($76.79 in chips)
Seat 3: Faradaay ($128.11 in chips)
Seat 4: mizerysage ($56.62 in chips)
Seat 5: Sensei2212 ($89.11 in chips)
GNicki: posts small blind $0.25
Faradaay: posts big blind $0.50
*** HOLE CARDS ***
mizerysage: folds
mizerysage leaves the table
Sensei2212: folds
GNicki: raises $0.62 to $1.12
Faradaay: calls $0.62
*** FLOP *** [4d 6d Th]
ManOnTh3Moon joins the table at seat #4
GNicki: checks
ManOnTh3Moon leaves the table
Faradaay: checks
*** TURN *** [4d 6d Th] [8d]
DAVA2013 joins the table at seat #4
GNicki: bets $1.12
Faradaay: raises $2.86 to $3.98
GNicki: folds
Uncalled bet ($2.86) returned to Faradaay
Faradaay collected $4.26 from pot
*** SUMMARY ***
Total pot $4.48 | Rake $0.22
Board [4d 6d Th 8d]
Seat 1: GNicki (small blind) folded on the Turn
Seat 3: Faradaay (big blind) collected ($4.26)
Seat 4: mizerysage folded before Flop (didn't bet)
Seat 5: Sensei2212 (button) folded before Flop (didn't bet)


PokerStars Hand #208980239880:  Hold'em No Limit ($0.25/$0.50 USD) - 2020/02/08 13:29:56 ET
Table 'Acamar V' 6-max Seat #1 is the button
Seat 1: GNicki ($74.55 in chips)
Seat 3: Faradaay ($130.13 in chips)
Seat 4: DAVA2013 ($40 in chips)
Seat 5: Sensei2212 ($89.11 in chips)
Faradaay: posts small blind $0.25
DAVA2013: posts big blind $0.50
*** HOLE CARDS ***
Sensei2212: folds
GNicki: folds
Sensei2212 leaves the table
Faradaay: raises $0.75 to $1.25
DAVA2013: folds
Uncalled bet ($0.75) returned to Faradaay
Faradaay collected $1 from pot
*** SUMMARY ***
Total pot $1 | Rake $0
Seat 1: GNicki (button) folded before Flop (didn't bet)
Seat 3: Faradaay (small blind) collected ($1)
Seat 4: DAVA2013 (big blind) folded before Flop
Seat 5: Sensei2212 folded before Flop (didn't bet)


PokerStars Hand #208980279460:  Hold'em No Limit ($0.25/$0.50 USD) - 2020/02/08 13:30:57 ET
Table 'Acamar V' 6-max Seat #3 is the button
Seat 3: Faradaay ($131.08 in chips)
Seat 4: DAVA2013 ($39 in chips)
Seat 5: StayFit4 ($50 in chips)
DAVA2013: posts small blind $0.25
StayFit4: posts big blind $0.50
*** HOLE CARDS ***
Faradaay: folds
DAVA2013: folds
Uncalled bet ($0.25) returned to StayFit4
DAVA2013 leaves the table
StayFit4 collected $0.50 from pot
StayFit4: doesn't show hand
*** SUMMARY ***
Total pot $0.50 | Rake $0
Seat 3: Faradaay (button) folded before Flop (didn't bet)
Seat 4: DAVA2013 (small blind) folded before Flop
Seat 5: StayFit4 (big blind) collected ($0.50)


